CustomerID,Recency,Frequency,Monetary,R,M,F,RFMsum
2.0,16,33,93730.0,2,2,2,6
3.0,328,3,38448.0,4,4,4,12
4.0,22,8,18051.0,2,4,4,10
6.0,108,5,7596.0,4,4,4,12
8.0,237,6,13980.0,4,4,4,12
10.0,16,4,20856.0,2,4,4,10
11.0,9,15,79738.0,1,2,4,7
13.0,18,19,34647.0,2,4,4,10
14.0,57,9,21012.0,3,4,4,11
15.0,170,4,10650.0,4,4,4,12
16.0,12,40,95351.0,2,2,2,6
18.0,38,1,1100.0,3,4,4,11
20.0,38,4,8946.0,3,4,4,11
21.0,17,5,17132.0,2,4,4,10
22.0,61,4,12060.0,3,4,4,11
23.0,81,16,58494.0,3,2,4,9
24.0,140,2,9092.0,4,4,4,12
25.0,29,1,2160.0,3,4,4,11
26.0,41,2,7790.0,3,4,4,11
27.0,171,17,36482.0,4,4,4,12
28.0,12,19,45875.0,2,4,4,10
29.0,74,5,12950.0,3,4,4,11
30.0,26,9,31884.0,3,4,4,11
31.0,120,12,29152.0,4,4,4,12
32.0,272,18,58153.0,4,2,4,10
33.0,42,1,1890.0,3,4,4,11
34.0,367,2,7536.0,4,4,4,12
35.0,78,7,17910.0,3,4,4,11
36.0,82,7,19980.0,3,4,4,11
38.0,224,4,9444.0,4,4,4,12
39.0,106,3,8304.0,4,4,4,12
40.0,9,37,99495.0,1,2,2,5
41.0,70,18,48720.0,3,4,4,11
42.0,51,12,32514.0,3,4,4,11
43.0,125,3,21288.0,4,4,4,12
45.0,328,3,8796.0,4,4,4,12
47.0,152,4,18072.0,4,4,4,12
48.0,27,11,30828.0,3,4,4,11
49.0,58,1,2225.0,3,4,4,11
50.0,9,19,82088.0,1,2,4,7
51.0,82,8,85230.0,3,2,4,9
52.0,171,5,9412.0,4,4,4,12
53.0,83,7,23838.0,3,4,4,11
54.0,19,7,16284.0,2,4,4,10
56.0,25,74,1636053.0,3,1,2,6
57.0,38,12,23764.0,3,4,4,11
58.0,114,4,7884.0,4,4,4,12
60.0,22,6,9426.0,2,4,4,10
61.0,11,2,4978.0,2,4,4,10
62.0,7,14,26238.0,1,4,4,9
63.0,74,1,1524.0,3,4,4,11
64.0,84,1,2928.0,3,4,4,11
65.0,136,5,15144.0,4,4,4,12
66.0,64,1,2892.0,3,4,4,11
67.0,12,23,59546.0,2,2,4,8
68.0,69,15,73220.0,3,2,4,9
69.0,52,1,1800.0,3,4,4,11
70.0,10,58,282188.0,1,1,2,4
71.0,51,15,105956.0,3,2,4,9
72.0,1,96,448940.0,1,1,1,3
73.0,230,3,-909.0,4,4,4,12
74.0,88,4,84646.0,4,2,4,10
75.0,164,1,1848.0,4,4,4,12
76.0,69,9,25236.0,3,4,4,11
77.0,146,8,20014.0,4,4,4,12
78.0,367,2,4275.0,4,4,4,12
79.0,7,3,6360.0,1,4,4,9
80.0,26,12,26098.0,3,4,4,11
81.0,25,2,6468.0,3,4,4,11
82.0,58,3,6432.0,3,4,4,11
83.0,244,5,13810.0,4,4,4,12
84.0,50,4,15529.0,3,4,4,11
85.0,12,33,101212.0,2,2,2,6
87.0,22,38,154742.0,2,1,2,5
88.0,21,2,4192.0,2,4,4,10
89.0,144,3,7077.0,4,4,4,12
90.0,63,1,35568.0,3,4,4,11
92.0,51,9,27047.0,3,4,4,11
93.0,89,6,15623.0,4,4,4,12
94.0,78,5,20578.0,3,4,4,11
95.0,43,2,3276.0,3,4,4,11
96.0,27,2,2784.0,3,4,4,11
97.0,58,14,33604.0,3,4,4,11
99.0,22,4,8808.0,2,4,4,10
100.0,44,5,15196.0,3,4,4,11
101.0,5,54,235132.0,1,1,2,4
102.0,18,45,92476.0,2,2,2,6
103.0,56,11,20871.0,3,4,4,11
104.0,24,50,127282.0,2,2,2,6
105.0,55,2,5350.0,3,4,4,11
106.0,22,20,62418.0,2,2,4,8
107.0,24,22,181013.0,2,1,4,7
108.0,6,3,8198.0,1,4,4,9
109.0,191,1,552.0,4,4,4,12
110.0,19,16,76013.0,2,2,4,8
111.0,19,19,45721.0,2,4,4,10
112.0,20,9,35374.0,2,4,4,10
113.0,49,16,18057.0,3,4,4,11
114.0,84,3,14856.0,3,4,4,11
115.0,141,1,1374.0,4,4,4,12
116.0,9,23,72492.0,1,2,4,7
117.0,253,3,6796.0,4,4,4,12
118.0,66,2,5166.0,3,4,4,11
119.0,258,1,3706.0,4,4,4,12
120.0,43,9,12124.0,3,4,4,11
122.0,24,1,1690.0,2,4,4,10
123.0,28,15,204996.0,3,1,4,8
124.0,19,20,29697.0,2,4,4,10
125.0,41,13,28349.0,3,4,4,11
129.0,239,1,301.0,4,4,4,12
131.0,9,4,1349.0,1,4,4,9
132.0,200,1,1450.0,4,4,4,12
133.0,327,6,14330.0,4,4,4,12
134.0,163,2,1836.0,4,4,4,12
135.0,116,2,3610.0,4,4,4,12
136.0,269,7,13398.0,4,4,4,12
138.0,182,5,16176.0,4,4,4,12
139.0,14,21,29509.0,2,4,4,10
140.0,4,13,35522.0,1,4,4,9
141.0,40,4,9654.0,3,4,4,11
142.0,84,13,33744.0,3,4,4,11
143.0,144,5,9872.0,4,4,4,12
144.0,56,1,2100.0,3,4,4,11
145.0,10,11,25990.0,1,4,4,9
146.0,45,26,113854.0,3,2,4,9
147.0,2,9,23046.0,1,4,4,9
148.0,91,2,2920.0,4,4,4,12
150.0,62,3,8570.0,3,4,4,11
151.0,20,5,2260.0,2,4,4,10
152.0,35,1,1530.0,3,4,4,11
153.0,287,2,3498.0,4,4,4,12
154.0,105,1,2240.0,4,4,4,12
155.0,10,20,38725.0,1,4,4,9
156.0,31,1,2046.0,3,4,4,11
157.0,19,16,39424.0,2,4,4,10
158.0,20,44,124780.0,2,2,2,6
159.0,39,2,4548.0,3,4,4,11
161.0,84,3,5688.0,3,4,4,11
162.0,56,2,3438.0,3,4,4,11
165.0,81,9,20296.0,3,4,4,11
166.0,364,1,2720.0,4,4,4,12
168.0,26,23,52599.0,3,2,4,9
169.0,52,5,2248.0,3,4,4,11
171.0,7,2,2016.0,1,4,4,9
172.0,321,5,11384.0,4,4,4,12
173.0,6,10,23610.0,1,4,4,9
174.0,305,3,7158.0,4,4,4,12
175.0,23,24,51930.0,2,2,4,8
176.0,266,5,13440.0,4,4,4,12
177.0,292,1,2052.0,4,4,4,12
179.0,11,52,140053.0,2,2,2,6
180.0,25,7,17568.0,3,4,4,11
181.0,42,2,6840.0,3,4,4,11
182.0,55,8,12640.0,3,4,4,11
184.0,201,1,2046.0,4,4,4,12
185.0,98,5,7059.0,4,4,4,12
186.0,70,8,4115.0,3,4,4,11
187.0,22,8,26868.0,2,4,4,10
188.0,86,1,1800.0,4,4,4,12
189.0,250,1,3012.0,4,4,4,12
190.0,223,1,2232.0,4,4,4,12
191.0,245,1,4224.0,4,4,4,12
192.0,5,65,341129.0,1,1,2,4
193.0,17,8,17009.0,2,4,4,10
194.0,202,10,42892.0,4,4,4,12
195.0,372,1,-1818.0,4,4,4,12
197.0,284,3,4992.0,4,4,4,12
199.0,167,13,180568.0,4,1,4,9
200.0,321,2,3330.0,4,4,4,12
201.0,45,3,7860.0,3,4,4,11
202.0,15,5,13692.0,2,4,4,10
203.0,55,12,40000.0,3,4,4,11
204.0,59,3,10113.0,3,4,4,11
205.0,14,11,23730.0,2,4,4,10
206.0,21,15,42942.0,2,4,4,10
207.0,9,6,12792.0,1,4,4,9
208.0,33,11,93459.0,3,2,4,9
209.0,310,2,3432.0,4,4,4,12
214.0,40,14,-1610.0,3,4,4,11
215.0,14,7,21504.0,2,4,4,10
216.0,54,2,4011.0,3,4,4,11
217.0,53,7,22022.0,3,4,4,11
218.0,83,1,4488.0,3,4,4,11
219.0,34,11,28541.0,3,4,4,11
221.0,5,15,37344.0,1,4,4,9
222.0,96,5,11604.0,4,4,4,12
225.0,20,5,20352.0,2,4,4,10
226.0,20,7,18564.0,2,4,4,10
227.0,5,61,256966.0,1,1,2,4
228.0,242,1,1776.0,4,4,4,12
229.0,78,3,9792.0,3,4,4,11
230.0,113,4,8556.0,4,4,4,12
231.0,214,8,25614.0,4,4,4,12
232.0,12,29,74952.0,2,2,2,6
233.0,10,27,73549.0,1,2,2,5
235.0,51,3,5988.0,3,4,4,11
236.0,61,2,6474.0,3,4,4,11
237.0,67,8,15906.0,3,4,4,11
238.0,93,4,10530.0,4,4,4,12
239.0,10,54,127378.0,1,2,2,5
240.0,35,5,11298.0,3,4,4,11
242.0,29,10,25656.0,3,4,4,11
244.0,34,2,7800.0,3,4,4,11
246.0,103,3,7932.0,4,4,4,12
247.0,15,10,39732.0,2,4,4,10
249.0,13,18,47147.0,2,4,4,10
250.0,74,1,4760.0,3,4,4,11
251.0,111,6,26850.0,4,4,4,12
252.0,6,2,1920.0,1,4,4,9
253.0,19,3,5730.0,2,4,4,10
254.0,334,5,10412.0,4,4,4,12
255.0,152,12,73510.0,4,2,4,10
256.0,131,4,9682.0,4,4,4,12
257.0,22,20,69500.0,2,2,4,8
258.0,81,7,10501.0,3,4,4,11
259.0,20,3,5194.0,2,4,4,10
261.0,191,3,11196.0,4,4,4,12
262.0,3,29,76418.0,1,2,2,5
266.0,62,2,4248.0,3,4,4,11
267.0,20,10,24960.0,2,4,4,10
268.0,151,18,39168.0,4,4,4,12
269.0,11,20,84696.0,2,2,4,8
271.0,8,4,6978.0,1,4,4,9
272.0,11,29,64199.0,2,2,2,6
273.0,28,2,4224.0,3,4,4,11
274.0,50,28,305467.0,3,1,2,6
275.0,231,4,11208.0,4,4,4,12
276.0,1,18,37556.0,1,4,4,9
277.0,9,76,241772.0,1,1,2,4
278.0,4,46,109058.0,1,2,2,5
279.0,7,23,65594.0,1,2,4,7
280.0,29,18,89664.0,3,2,4,9
281.0,11,25,53238.0,2,2,4,8
282.0,464,4,7490.0,4,4,4,12
283.0,114,15,63640.0,4,2,4,10
284.0,26,7,17470.0,3,4,4,11
285.0,213,2,7440.0,4,4,4,12
286.0,36,4,37188.0,3,4,4,11
287.0,273,4,8280.0,4,4,4,12
288.0,75,7,16320.0,3,4,4,11
289.0,111,2,3912.0,4,4,4,12
291.0,10,27,65682.0,1,2,2,5
292.0,243,7,12600.0,4,4,4,12
294.0,163,1,1632.0,4,4,4,12
295.0,9,7,22776.0,1,4,4,9
296.0,13,48,129580.0,2,2,2,6
297.0,301,2,5226.0,4,4,4,12
298.0,9,23,56167.0,1,2,4,7
299.0,11,36,99419.0,2,2,2,6
300.0,11,7,18096.0,2,4,4,10
301.0,150,6,14861.0,4,4,4,12
302.0,3,1,2880.0,1,4,4,9
303.0,69,15,33810.0,3,4,4,11
304.0,111,3,7654.0,4,4,4,12
305.0,5,3,6006.0,1,4,4,9
306.0,246,1,1864.0,4,4,4,12
307.0,193,1,2448.0,4,4,4,12
308.0,68,2,5376.0,3,4,4,11
309.0,3,46,90946.0,1,2,2,5
310.0,18,14,35388.0,2,4,4,10
311.0,115,4,10572.0,4,4,4,12
312.0,101,5,5418.0,4,4,4,12
313.0,7,7,16286.0,1,4,4,9
314.0,372,7,12108.0,4,4,4,12
315.0,9,15,69764.0,1,2,4,7
316.0,20,11,30640.0,2,4,4,10
317.0,193,4,8622.0,4,4,4,12
319.0,15,30,373160.0,2,1,2,5
321.0,238,1,1074.0,4,4,4,12
323.0,110,6,14257.0,4,4,4,12
326.0,72,3,7818.0,3,4,4,11
327.0,40,1,2760.0,3,4,4,11
328.0,142,12,5718.0,4,4,4,12
329.0,61,17,95234.0,3,2,4,9
331.0,3,281,221096.0,1,1,1,3
332.0,4,21,39615.0,1,4,4,9
333.0,165,3,4690.0,4,4,4,12
334.0,82,7,61428.0,3,2,4,9
335.0,7,34,279082.0,1,1,2,4
336.0,18,17,313427.0,2,1,4,7
339.0,10,10,10403.0,1,4,4,9
340.0,17,10,28925.0,2,4,4,10
341.0,56,8,19006.0,3,4,4,11
342.0,8,4,13308.0,1,4,4,9
343.0,556,1,1260.0,4,4,4,12
344.0,201,4,16896.0,4,4,4,12
345.0,7,26,64599.0,1,2,4,7
346.0,239,2,5628.0,4,4,4,12
347.0,212,1,33240.0,4,4,4,12
348.0,62,2,3636.0,3,4,4,11
350.0,67,1,1440.0,3,4,4,11
351.0,31,9,34210.0,3,4,4,11
352.0,64,6,25308.0,3,4,4,11
353.0,69,14,29735.0,3,4,4,11
354.0,60,7,12292.0,3,4,4,11
355.0,20,4,3054.0,2,4,4,10
356.0,366,1,1950.0,4,4,4,12
357.0,11,2,8016.0,2,4,4,10
359.0,258,3,5832.0,4,4,4,12
361.0,265,6,12594.0,4,4,4,12
362.0,337,2,4630.0,4,4,4,12
363.0,11,1,2040.0,2,4,4,10
364.0,342,1,1992.0,4,4,4,12
365.0,365,6,12228.0,4,4,4,12
366.0,174,1,50544.0,4,4,4,12
367.0,75,2,6156.0,3,4,4,11
369.0,180,2,6114.0,4,4,4,12
370.0,200,3,8334.0,4,4,4,12
371.0,253,1,2370.0,4,4,4,12
373.0,205,2,5380.0,4,4,4,12
374.0,96,3,5882.0,4,4,4,12
377.0,50,7,14312.0,3,4,4,11
379.0,89,3,8204.0,4,4,4,12
381.0,67,1,2184.0,3,4,4,11
382.0,34,7,15622.0,3,4,4,11
384.0,315,1,5328.0,4,4,4,12
388.0,36,1,1764.0,3,4,4,11
390.0,261,1,3420.0,4,4,4,12
391.0,45,11,14510.0,3,4,4,11
393.0,35,7,6189.0,3,4,4,11
394.0,4,34,71138.0,1,2,2,5
395.0,198,1,2600.0,4,4,4,12
396.0,18,19,19472.0,2,4,4,10
397.0,79,1,6583.0,3,4,4,11
398.0,43,6,10313.0,3,4,4,11
399.0,134,1,120.0,4,4,4,12
400.0,261,6,29608.0,4,4,4,12
401.0,27,7,8807.0,3,4,4,11
402.0,271,4,7012.0,4,4,4,12
403.0,11,6,1881.0,2,4,4,10
405.0,165,7,9610.0,4,4,4,12
406.0,242,2,1150.0,4,4,4,12
408.0,40,14,9667.0,3,4,4,11
409.0,307,1,1848.0,4,4,4,12
412.0,12,6,15126.0,2,4,4,10
413.0,139,1,1758.0,4,4,4,12
414.0,11,37,33042.0,2,4,2,8
415.0,15,3,6360.0,2,4,4,10
418.0,328,5,4757.0,4,4,4,12
421.0,60,8,35850.0,3,4,4,11
422.0,25,16,23838.0,3,4,4,11
423.0,240,2,4764.0,4,4,4,12
427.0,97,1,2106.0,4,4,4,12
429.0,10,2,3504.0,1,4,4,9
430.0,10,12,18816.0,1,4,4,9
432.0,25,10,3157.0,3,4,4,11
434.0,31,1,492.0,3,4,4,11
435.0,93,3,2572.0,4,4,4,12
437.0,165,13,245973.0,4,1,4,9
438.0,267,2,3294.0,4,4,4,12
439.0,21,2,2442.0,2,4,4,10
440.0,21,9,57480.0,2,2,4,8
442.0,88,4,17964.0,4,4,4,12
443.0,29,8,27804.0,3,4,4,11
444.0,162,1,11208.0,4,4,4,12
445.0,99,2,3699.0,4,4,4,12
449.0,34,3,11472.0,3,4,4,11
450.0,21,3,1995.0,2,4,4,10
451.0,20,37,88756.0,2,2,2,6
453.0,66,4,1504.0,3,4,4,11
454.0,95,1,736.0,4,4,4,12
455.0,5,7,14247.0,1,4,4,9
459.0,73,14,639910.0,3,1,4,8
460.0,25,6,4147.0,3,4,4,11
461.0,69,2,3930.0,3,4,4,11
462.0,88,2,2911.0,4,4,4,12
463.0,20,9,9310.0,2,4,4,10
464.0,32,1,1284.0,3,4,4,11
465.0,17,3,137100.0,2,2,4,8
466.0,55,5,5250.0,3,4,4,11
467.0,103,4,1321.0,4,4,4,12
469.0,36,4,10500.0,3,4,4,11
471.0,110,3,15382.0,4,4,4,12
472.0,255,4,6936.0,4,4,4,12
473.0,32,9,22278.0,3,4,4,11
474.0,3,2,10200.0,1,4,4,9
475.0,177,4,3165.0,4,4,4,12
476.0,38,2,3552.0,3,4,4,11
478.0,3,25,81016.0,1,2,4,7
479.0,308,1,379.0,4,4,4,12
480.0,31,8,21234.0,3,4,4,11
481.0,123,1,2796.0,4,4,4,12
482.0,29,4,9944.0,3,4,4,11
483.0,11,9,6952.0,2,4,4,10
487.0,69,4,1256.0,3,4,4,11
488.0,70,3,6108.0,3,4,4,11
494.0,244,3,4289.0,4,4,4,12
496.0,2,7,35629.0,1,4,4,9
497.0,224,1,5160.0,4,4,4,12
498.0,295,7,3511.0,4,4,4,12
499.0,38,5,12490.0,3,4,4,11
501.0,116,3,6328.0,4,4,4,12
502.0,12,3,5700.0,2,4,4,10
503.0,125,6,9100.0,4,4,4,12
504.0,82,2,3705.0,3,4,4,11
505.0,32,7,23850.0,3,4,4,11
506.0,46,1,4536.0,3,4,4,11
507.0,269,1,2484.0,4,4,4,12
508.0,27,4,7608.0,3,4,4,11
509.0,327,1,1890.0,4,4,4,12
510.0,218,1,2058.0,4,4,4,12
511.0,16,22,40768.0,2,4,4,10
512.0,248,1,1914.0,4,4,4,12
514.0,329,2,2832.0,4,4,4,12
515.0,434,1,1815.0,4,4,4,12
516.0,27,7,13428.0,3,4,4,11
517.0,24,11,32063.0,2,4,4,10
518.0,30,9,25308.0,3,4,4,11
519.0,56,13,25659.0,3,4,4,11
520.0,193,1,1830.0,4,4,4,12
522.0,23,28,64549.0,2,2,2,6
523.0,28,4,11336.0,3,4,4,11
524.0,134,2,4542.0,4,4,4,12
525.0,2,4,9222.0,1,4,4,9
527.0,31,4,9102.0,3,4,4,11
528.0,35,1,2544.0,3,4,4,11
529.0,130,8,5097.0,4,4,4,12
532.0,60,2,3882.0,3,4,4,11
533.0,344,1,8424.0,4,4,4,12
535.0,89,5,10678.0,4,4,4,12
536.0,38,1,2232.0,3,4,4,11
537.0,277,4,9344.0,4,4,4,12
538.0,298,1,2148.0,4,4,4,12
539.0,41,1,2124.0,3,4,4,11
540.0,33,1,2460.0,3,4,4,11
541.0,129,3,3873.0,4,4,4,12
542.0,21,11,12363.0,2,4,4,10
543.0,323,1,1158.0,4,4,4,12
544.0,12,23,36847.0,2,4,4,10
546.0,81,5,11649.0,3,4,4,11
548.0,138,1,924.0,4,4,4,12
549.0,169,2,4076.0,4,4,4,12
550.0,82,1,2400.0,3,4,4,11
552.0,21,1,488.0,2,4,4,10
553.0,648,1,950.0,4,4,4,12
554.0,34,2,3267.0,3,4,4,11
557.0,6,28,34700.0,1,4,2,7
558.0,197,1,2840.0,4,4,4,12
559.0,270,1,2148.0,4,4,4,12
560.0,287,2,8460.0,4,4,4,12
561.0,2,8,4710.0,1,4,4,9
562.0,30,48,163302.0,3,1,2,6
564.0,189,1,1800.0,4,4,4,12
565.0,9,80,252498.0,1,1,1,3
566.0,12,11,26298.0,2,4,4,10
567.0,6,3,8496.0,1,4,4,9
568.0,74,4,7480.0,3,4,4,11
569.0,5,107,345888.0,1,1,1,3
570.0,26,5,10872.0,3,4,4,11
572.0,193,6,13566.0,4,4,4,12
573.0,18,17,79532.0,2,2,4,8
575.0,193,1,2976.0,4,4,4,12
576.0,9,61,101949.0,1,2,2,5
577.0,9,31,192107.0,1,1,2,4
580.0,16,66,190833.0,2,1,2,5
581.0,192,1,5394.0,4,4,4,12
582.0,95,1,3144.0,4,4,4,12
584.0,49,4,10233.0,3,4,4,11
585.0,373,3,20304.0,4,4,4,12
586.0,104,1,2844.0,4,4,4,12
587.0,139,4,5383.0,4,4,4,12
588.0,12,13,18069.0,2,4,4,10
589.0,44,4,13525.0,3,4,4,11
591.0,280,3,4188.0,4,4,4,12
594.0,277,1,576.0,4,4,4,12
595.0,242,9,19170.0,4,4,4,12
596.0,11,22,36939.0,2,4,4,10
597.0,47,7,12567.0,3,4,4,11
598.0,87,1,1270.0,4,4,4,12
599.0,98,1,4920.0,4,4,4,12
600.0,26,5,21228.0,3,4,4,11
603.0,86,6,13396.0,4,4,4,12
605.0,64,10,28412.0,3,4,4,11
606.0,20,42,35439.0,2,4,2,8
608.0,9,13,40098.0,1,4,4,9
609.0,367,1,215.0,4,4,4,12
610.0,85,8,26446.0,4,4,4,12
611.0,21,1,1234.0,2,4,4,10
613.0,90,2,1062.0,4,4,4,12
616.0,30,17,15912.0,3,4,4,11
617.0,311,1,2220.0,4,4,4,12
618.0,297,4,8159.0,4,4,4,12
621.0,373,3,2812.0,4,4,4,12
622.0,58,6,17966.0,3,4,4,11
623.0,41,8,13108.0,3,4,4,11
624.0,38,7,11597.0,3,4,4,11
625.0,31,1,2592.0,3,4,4,11
627.0,243,8,24372.0,4,4,4,12
628.0,50,2,6648.0,3,4,4,11
629.0,78,4,5106.0,3,4,4,11
630.0,42,6,4259.0,3,4,4,11
631.0,323,3,3766.0,4,4,4,12
634.0,307,2,964.0,4,4,4,12
635.0,368,2,2740.0,4,4,4,12
636.0,21,6,6543.0,2,4,4,10
637.0,55,4,5543.0,3,4,4,11
639.0,9,18,49384.0,1,4,4,9
641.0,80,8,59928.0,3,2,4,9
642.0,105,7,4758.0,4,4,4,12
644.0,97,4,6438.0,4,4,4,12
645.0,141,3,517.0,4,4,4,12
647.0,119,4,6432.0,4,4,4,12
648.0,208,1,2412.0,4,4,4,12
651.0,89,5,11328.0,4,4,4,12
652.0,12,25,53578.0,2,2,4,8
653.0,20,13,274200.0,2,1,4,7
654.0,224,4,9096.0,4,4,4,12
655.0,70,3,6804.0,3,4,4,11
657.0,43,6,6186.0,3,4,4,11
658.0,9,49,128999.0,1,2,2,5
660.0,11,2,2942.0,2,4,4,10
661.0,20,8,4424.0,2,4,4,10
665.0,134,1,1224.0,4,4,4,12
667.0,242,5,10282.0,4,4,4,12
669.0,10,4,5855.0,1,4,4,9
674.0,168,1,2358.0,4,4,4,12
675.0,43,33,13160.0,3,4,2,9
676.0,11,24,20658.0,2,4,4,10
677.0,82,5,10788.0,3,4,4,11
678.0,213,1,2064.0,4,4,4,12
679.0,113,2,6018.0,4,4,4,12
684.0,204,7,7395.0,4,4,4,12
686.0,60,1,3012.0,3,4,4,11
687.0,211,7,6740.0,4,4,4,12
689.0,44,3,5874.0,3,4,4,11
691.0,157,5,14844.0,4,4,4,12
694.0,25,1,1572.0,3,4,4,11
695.0,62,3,804.0,3,4,4,11
698.0,268,1,1296.0,4,4,4,12
699.0,6,78,44346.0,1,4,1,6
700.0,54,5,21852.0,3,4,4,11
701.0,9,17,61858.0,1,2,4,7
702.0,33,19,41304.0,3,4,4,11
703.0,22,32,34225.0,2,4,2,8
704.0,16,39,89849.0,2,2,2,6
706.0,39,7,1349.0,3,4,4,11
707.0,90,1,2160.0,4,4,4,12
708.0,116,1,828.0,4,4,4,12
711.0,131,5,8029.0,4,4,4,12
713.0,141,3,2935.0,4,4,4,12
714.0,15,10,43218.0,2,4,4,10
715.0,66,2,2926.0,3,4,4,11
717.0,24,15,24648.0,2,4,4,10
723.0,38,1,2712.0,3,4,4,11
725.0,270,1,2196.0,4,4,4,12
726.0,173,3,8400.0,4,4,4,12
727.0,299,1,813.0,4,4,4,12
729.0,353,3,6138.0,4,4,4,12
730.0,26,2,3300.0,3,4,4,11
732.0,14,5,10749.0,2,4,4,10
733.0,109,2,2274.0,4,4,4,12
734.0,9,4,5604.0,1,4,4,9
735.0,151,3,4497.0,4,4,4,12
736.0,172,1,2292.0,4,4,4,12
737.0,57,5,2227.0,3,4,4,11
738.0,73,2,1064.0,3,4,4,11
739.0,67,7,9970.0,3,4,4,11
740.0,69,5,24468.0,3,4,4,11
741.0,9,36,90949.0,1,2,2,5
742.0,45,14,23168.0,3,4,4,11
744.0,342,1,522.0,4,4,4,12
746.0,90,4,34512.0,4,4,4,12
747.0,87,1,2520.0,4,4,4,12
748.0,162,3,7710.0,4,4,4,12
749.0,232,3,30936.0,4,4,4,12
750.0,34,4,11843.0,3,4,4,11
751.0,41,2,4788.0,3,4,4,11
753.0,18,20,25183.0,2,4,4,10
754.0,81,2,4560.0,3,4,4,11
755.0,104,3,6372.0,4,4,4,12
756.0,203,4,8178.0,4,4,4,12
757.0,142,4,41004.0,4,4,4,12
758.0,264,4,9198.0,4,4,4,12
759.0,178,2,7592.0,4,4,4,12
760.0,17,7,15944.0,2,4,4,10
761.0,200,2,8022.0,4,4,4,12
762.0,163,1,5076.0,4,4,4,12
763.0,67,1,2496.0,3,4,4,11
764.0,99,1,5077.0,4,4,4,12
765.0,20,3,11197.0,2,4,4,10
766.0,68,2,10349.0,3,4,4,11
767.0,62,3,8777.0,3,4,4,11
768.0,163,5,8850.0,4,4,4,12
769.0,73,4,9318.0,3,4,4,11
770.0,81,3,7152.0,3,4,4,11
771.0,230,9,5985.0,4,4,4,12
772.0,270,4,11793.0,4,4,4,12
773.0,10,3,6870.0,1,4,4,9
774.0,16,9,18171.0,2,4,4,10
775.0,20,8,21803.0,2,4,4,10
777.0,34,16,27153.0,3,4,4,11
779.0,199,4,12201.0,4,4,4,12
780.0,366,1,5094.0,4,4,4,12
781.0,373,3,6350.0,4,4,4,12
782.0,96,2,7267.0,4,4,4,12
783.0,43,4,6584.0,3,4,4,11
784.0,90,3,5019.0,4,4,4,12
785.0,41,3,15107.0,3,4,4,11
786.0,30,8,4911.0,3,4,4,11
787.0,9,24,62064.0,1,2,4,7
789.0,50,12,25763.0,3,4,4,11
792.0,81,2,6981.0,3,4,4,11
793.0,81,2,5104.0,3,4,4,11
795.0,39,11,13950.0,3,4,4,11
796.0,136,1,7236.0,4,4,4,12
797.0,31,2,6024.0,3,4,4,11
798.0,19,6,15046.0,2,4,4,10
799.0,317,2,4345.0,4,4,4,12
800.0,226,2,2652.0,4,4,4,12
801.0,311,1,1696.0,4,4,4,12
804.0,10,46,224663.0,1,1,2,4
805.0,26,11,67558.0,3,2,4,9
807.0,134,5,18384.0,4,4,4,12
808.0,82,4,14420.0,3,4,4,11
809.0,99,1,2328.0,4,4,4,12
810.0,41,30,109543.0,3,2,2,7
813.0,292,2,4991.0,4,4,4,12
814.0,40,9,20358.0,3,4,4,11
815.0,300,1,1530.0,4,4,4,12
816.0,27,7,18722.0,3,4,4,11
818.0,130,5,2493.0,4,4,4,12
819.0,10,2,7776.0,1,4,4,9
820.0,26,6,14928.0,3,4,4,11
821.0,89,3,10034.0,4,4,4,12
822.0,83,2,6108.0,3,4,4,11
823.0,32,7,46048.0,3,4,4,11
825.0,9,12,26800.0,1,4,4,9
826.0,169,2,1236.0,4,4,4,12
828.0,25,1,4188.0,3,4,4,11
829.0,15,18,32418.0,2,4,4,10
830.0,24,3,6612.0,2,4,4,10
831.0,11,10,33960.0,2,4,4,10
832.0,12,27,23808.0,2,4,2,8
834.0,261,1,3012.0,4,4,4,12
835.0,367,2,4708.0,4,4,4,12
836.0,10,5,15684.0,1,4,4,9
837.0,19,15,34797.0,2,4,4,10
838.0,37,3,6080.0,3,4,4,11
839.0,347,1,5100.0,4,4,4,12
841.0,60,6,16162.0,3,4,4,11
842.0,185,1,2900.0,4,4,4,12
843.0,9,9,7716.0,1,4,4,9
844.0,6,14,40017.0,1,4,4,9
846.0,7,14,16905.0,1,4,4,9
847.0,334,2,4044.0,4,4,4,12
848.0,239,2,820.0,4,4,4,12
850.0,47,5,10001.0,3,4,4,11
851.0,62,9,21648.0,3,4,4,11
853.0,53,10,16464.0,3,4,4,11
854.0,349,2,4650.0,4,4,4,12
855.0,68,2,5328.0,3,4,4,11
857.0,238,2,5436.0,4,4,4,12
858.0,42,4,9840.0,3,4,4,11
860.0,192,11,29961.0,4,4,4,12
861.0,296,1,1632.0,4,4,4,12
862.0,47,2,3600.0,3,4,4,11
863.0,216,1,2244.0,4,4,4,12
864.0,278,3,50136.0,4,4,4,12
865.0,109,2,3750.0,4,4,4,12
867.0,191,2,2676.0,4,4,4,12
868.0,139,1,2820.0,4,4,4,12
870.0,28,9,12258.0,3,4,4,11
871.0,292,2,2922.0,4,4,4,12
873.0,344,1,1440.0,4,4,4,12
874.0,66,2,4382.0,3,4,4,11
875.0,68,10,17460.0,3,4,4,11
876.0,371,2,6792.0,4,4,4,12
877.0,69,4,8448.0,3,4,4,11
879.0,138,2,15732.0,4,4,4,12
880.0,44,5,8122.0,3,4,4,11
881.0,264,2,3978.0,4,4,4,12
884.0,82,7,10094.0,3,4,4,11
885.0,285,2,4770.0,4,4,4,12
886.0,63,8,13203.0,3,4,4,11
887.0,86,7,15574.0,4,4,4,12
889.0,60,13,104650.0,3,2,4,9
890.0,2,27,7980.0,1,4,2,7
892.0,34,12,33150.0,3,4,4,11
895.0,93,8,21601.0,4,4,4,12
897.0,368,2,4398.0,4,4,4,12
898.0,9,2,472.0,1,4,4,9
899.0,268,6,2084.0,4,4,4,12
900.0,6,13,29672.0,1,4,4,9
901.0,26,11,14717.0,3,4,4,11
903.0,93,2,3576.0,4,4,4,12
904.0,70,6,2449.0,3,4,4,11
905.0,22,8,6649.0,2,4,4,10
906.0,98,5,2433.0,4,4,4,12
907.0,210,1,2328.0,4,4,4,12
909.0,85,7,23267.0,4,4,4,12
910.0,81,10,44487.0,3,4,4,11
911.0,32,3,7516.0,3,4,4,11
912.0,29,5,2321.0,3,4,4,11
913.0,191,1,770.0,4,4,4,12
914.0,106,1,801.0,4,4,4,12
915.0,83,2,3885.0,3,4,4,11
916.0,86,1,2892.0,4,4,4,12
917.0,355,5,5098.0,4,4,4,12
919.0,84,10,7271.0,3,4,4,11
920.0,174,1,254.0,4,4,4,12
921.0,20,8,3891.0,2,4,4,10
922.0,246,1,1136.0,4,4,4,12
923.0,20,36,28175.0,2,4,2,8
924.0,211,2,4596.0,4,4,4,12
925.0,52,3,2063.0,3,4,4,11
926.0,71,1,2070.0,3,4,4,11
927.0,55,1,1273.0,3,4,4,11
928.0,34,7,12063.0,3,4,4,11
929.0,403,1,902.0,4,4,4,12
931.0,74,5,16314.0,3,4,4,11
932.0,18,1,524.0,2,4,4,10
934.0,9,20,40382.0,1,4,4,9
936.0,53,5,13350.0,3,4,4,11
937.0,66,3,5504.0,3,4,4,11
939.0,74,7,7167.0,3,4,4,11
940.0,61,1,1120.0,3,4,4,11
941.0,20,9,3430.0,2,4,4,10
943.0,34,13,15530.0,3,4,4,11
944.0,321,1,441.0,4,4,4,12
945.0,50,5,4181.0,3,4,4,11
947.0,32,1,451.0,3,4,4,11
948.0,247,1,828.0,4,4,4,12
949.0,131,5,2264.0,4,4,4,12
950.0,14,8,3637.0,2,4,4,10
951.0,98,3,11844.0,4,4,4,12
952.0,28,12,11000.0,3,4,4,11
953.0,321,2,3141.0,4,4,4,12
956.0,122,2,3828.0,4,4,4,12
957.0,35,2,1089.0,3,4,4,11
958.0,260,1,2334.0,4,4,4,12
959.0,205,1,2556.0,4,4,4,12
960.0,144,1,1056.0,4,4,4,12
961.0,6,3,3997.0,1,4,4,9
963.0,16,8,16129.0,2,4,4,10
964.0,70,9,5960.0,3,4,4,11
965.0,68,2,4368.0,3,4,4,11
966.0,253,1,1848.0,4,4,4,12
969.0,82,3,6474.0,3,4,4,11
970.0,45,4,2034.0,3,4,4,11
971.0,11,2,2940.0,2,4,4,10
972.0,25,7,20268.0,3,4,4,11
974.0,235,2,3550.0,4,4,4,12
976.0,21,10,17953.0,2,4,4,10
977.0,131,1,1452.0,4,4,4,12
978.0,55,4,8052.0,3,4,4,11
979.0,51,12,22640.0,3,4,4,11
980.0,115,6,10698.0,4,4,4,12
981.0,19,4,2403.0,2,4,4,10
982.0,130,1,2364.0,4,4,4,12
983.0,94,2,5332.0,4,4,4,12
984.0,206,5,11620.0,4,4,4,12
985.0,92,5,12300.0,4,4,4,12
987.0,63,2,1120.0,3,4,4,11
988.0,150,4,755.0,4,4,4,12
989.0,24,22,28854.0,2,4,4,10
993.0,20,4,1435.0,2,4,4,10
994.0,160,1,2760.0,4,4,4,12
995.0,152,2,14148.0,4,4,4,12
996.0,2,11,12325.0,1,4,4,9
997.0,163,1,681.0,4,4,4,12
1000.0,63,3,276.0,3,4,4,11
1001.0,190,1,1640.0,4,4,4,12
1003.0,65,1,1656.0,3,4,4,11
1004.0,238,2,4728.0,4,4,4,12
1006.0,46,32,484320.0,3,1,2,6
1007.0,87,4,10452.0,4,4,4,12
1008.0,253,1,3375.0,4,4,4,12
1010.0,11,27,54489.0,2,2,2,6
1012.0,24,12,28138.0,2,4,4,10
1013.0,8,1,2820.0,1,4,4,9
1015.0,274,1,1188.0,4,4,4,12
1016.0,274,1,940.0,4,4,4,12
1017.0,6,28,50528.0,1,4,2,7
1021.0,19,6,4721.0,2,4,4,10
1022.0,274,1,380.0,4,4,4,12
1023.0,58,6,14780.0,3,4,4,11
1024.0,250,2,3936.0,4,4,4,12
1025.0,64,1,2562.0,3,4,4,11
1026.0,123,3,8048.0,4,4,4,12
1027.0,100,3,9480.0,4,4,4,12
1028.0,17,9,33654.0,2,4,4,10
1030.0,79,7,15382.0,3,4,4,11
1031.0,70,4,9540.0,3,4,4,11
1032.0,37,3,4590.0,3,4,4,11
1033.0,9,3,6210.0,1,4,4,9
1034.0,143,5,9780.0,4,4,4,12
1035.0,16,2,4692.0,2,4,4,10
1036.0,29,3,10236.0,3,4,4,11
1037.0,25,12,18149.0,3,4,4,11
1038.0,7,18,9248.0,1,4,4,9
1039.0,207,1,207.0,4,4,4,12
1042.0,132,1,2544.0,4,4,4,12
1043.0,15,27,33339.0,2,4,2,8
1044.0,7,17,104412.0,1,2,4,7
1045.0,102,7,7983.0,4,4,4,12
1048.0,98,2,3398.0,4,4,4,12
1049.0,55,2,5946.0,3,4,4,11
1050.0,298,1,829.0,4,4,4,12
1051.0,42,8,21282.0,3,4,4,11
1052.0,170,3,7048.0,4,4,4,12
1054.0,4,27,22476.0,1,4,2,7
1055.0,3,18,64736.0,1,2,4,7
1056.0,191,2,1853.0,4,4,4,12
1058.0,56,9,4523.0,3,4,4,11
1059.0,184,1,624.0,4,4,4,12
1062.0,19,14,13311.0,2,4,4,10
1063.0,19,74,268549.0,2,1,2,5
1064.0,6,16,24652.0,1,4,4,9
1065.0,46,7,18134.0,3,4,4,11
1066.0,35,18,10002.0,3,4,4,11
1068.0,18,19,226065.0,2,1,4,7
1069.0,225,2,4304.0,4,4,4,12
1070.0,8,5,3315.0,1,4,4,9
1071.0,230,1,558.0,4,4,4,12
1072.0,12,6,6646.0,2,4,4,10
1074.0,495,1,4536.0,4,4,4,12
1079.0,4,7,133081.0,1,2,4,7
1081.0,79,7,13566.0,3,4,4,11
1083.0,143,2,40872.0,4,4,4,12
1085.0,74,7,14574.0,3,4,4,11
1088.0,370,1,1686.0,4,4,4,12
1089.0,38,4,7922.0,3,4,4,11
1091.0,57,2,8034.0,3,4,4,11
1093.0,113,3,5217.0,4,4,4,12
1094.0,97,5,9375.0,4,4,4,12
1095.0,11,11,48644.0,2,4,4,10
1096.0,26,16,42866.0,3,4,4,11
1097.0,25,5,17154.0,3,4,4,11
1098.0,9,5,10368.0,1,4,4,9
1099.0,79,5,19786.0,3,4,4,11
1100.0,146,10,7162.0,4,4,4,12
1101.0,100,6,2756.0,4,4,4,12
1102.0,41,1,2712.0,3,4,4,11
1103.0,18,3,11028.0,2,4,4,10
1108.0,203,5,2514.0,4,4,4,12
1110.0,43,1,1684.0,3,4,4,11
1111.0,32,6,10362.0,3,4,4,11
1112.0,217,1,3125.0,4,4,4,12
1113.0,38,14,5204.0,3,4,4,11
1115.0,59,4,8976.0,3,4,4,11
1116.0,130,2,4974.0,4,4,4,12
1118.0,29,5,7718.0,3,4,4,11
1120.0,52,8,13386.0,3,4,4,11
1121.0,12,7,14312.0,2,4,4,10
1122.0,12,5,12346.0,2,4,4,10
1123.0,58,1,4068.0,3,4,4,11
1124.0,26,6,68642.0,3,2,4,9
1127.0,329,3,1812.0,4,4,4,12
1128.0,7,3,5721.0,1,4,4,9
1129.0,13,14,34548.0,2,4,4,10
1130.0,16,2,4098.0,2,4,4,10
1132.0,344,1,2010.0,4,4,4,12
1133.0,285,1,2480.0,4,4,4,12
1134.0,70,2,6960.0,3,4,4,11
1135.0,12,14,16787.0,2,4,4,10
1136.0,142,16,32306.0,4,4,4,12
1137.0,26,26,50866.0,3,2,4,9
1140.0,57,7,11488.0,3,4,4,11
1143.0,61,2,4323.0,3,4,4,11
1144.0,60,8,16686.0,3,4,4,11
1145.0,100,12,106566.0,4,2,4,10
1146.0,3,4,8760.0,1,4,4,9
1147.0,15,7,13448.0,2,4,4,10
1148.0,95,1,784.0,4,4,4,12
1149.0,209,1,1038.0,4,4,4,12
1150.0,193,1,1313.0,4,4,4,12
1154.0,31,4,9054.0,3,4,4,11
1155.0,10,4,39468.0,1,4,4,9
1156.0,298,1,2160.0,4,4,4,12
1157.0,31,1,3240.0,3,4,4,11
1158.0,37,5,10260.0,3,4,4,11
1159.0,58,1,2268.0,3,4,4,11
1160.0,332,1,888.0,4,4,4,12
1161.0,279,1,3156.0,4,4,4,12
1163.0,111,7,13560.0,4,4,4,12
1164.0,284,2,3276.0,4,4,4,12
1165.0,15,5,12656.0,2,4,4,10
1166.0,15,12,27556.0,2,4,4,10
1167.0,20,2,5508.0,2,4,4,10
1170.0,12,6,10277.0,2,4,4,10
1173.0,99,5,10696.0,4,4,4,12
1174.0,144,2,4314.0,4,4,4,12
1175.0,32,1,4080.0,3,4,4,11
1176.0,84,1,2964.0,3,4,4,11
1179.0,65,1,3000.0,3,4,4,11
1180.0,11,4,4816.0,2,4,4,10
1181.0,296,6,13834.0,4,4,4,12
1182.0,158,1,1878.0,4,4,4,12
1183.0,264,3,7808.0,4,4,4,12
1185.0,175,1,6480.0,4,4,4,12
1187.0,115,3,4536.0,4,4,4,12
1189.0,23,3,76464.0,2,2,4,8
1193.0,4,7,15228.0,1,4,4,9
1194.0,285,1,2952.0,4,4,4,12
1195.0,180,1,5640.0,4,4,4,12
1196.0,218,8,19386.0,4,4,4,12
1198.0,5,1,1080.0,1,4,4,9
1199.0,13,2,328.0,2,4,4,10
1200.0,8,9,5532.0,1,4,4,9
1202.0,78,8,5410.0,3,4,4,11
1205.0,140,1,2094.0,4,4,4,12
1207.0,10,57,82844.0,1,2,2,5
1208.0,76,6,9003.0,3,4,4,11
1211.0,54,1,1160.0,3,4,4,11
1212.0,9,31,19847.0,1,4,2,7
1215.0,81,3,5730.0,3,4,4,11
1217.0,70,9,13664.0,3,4,4,11
1218.0,63,9,13358.0,3,4,4,11
1219.0,332,2,5132.0,4,4,4,12
1220.0,12,20,56278.0,2,2,4,8
1221.0,26,1,4092.0,3,4,4,11
1222.0,21,8,18509.0,2,4,4,10
1224.0,15,2,5640.0,2,4,4,10
1228.0,10,10,21882.0,1,4,4,9
1229.0,57,5,10498.0,3,4,4,11
1230.0,15,7,25260.0,2,4,4,10
1231.0,217,1,7704.0,4,4,4,12
1232.0,54,2,4776.0,3,4,4,11
1233.0,142,5,9828.0,4,4,4,12
1234.0,12,22,76958.0,2,2,4,8
1235.0,84,10,85724.0,3,2,4,9
1236.0,249,1,1596.0,4,4,4,12
1237.0,204,6,10515.0,4,4,4,12
1239.0,111,1,2256.0,4,4,4,12
1240.0,81,4,14172.0,3,4,4,11
1241.0,53,2,6724.0,3,4,4,11
1242.0,43,18,46018.0,3,4,4,11
1243.0,51,8,38520.0,3,4,4,11
1244.0,20,5,10050.0,2,4,4,10
1245.0,74,2,9174.0,3,4,4,11
1246.0,168,3,6474.0,4,4,4,12
1247.0,8,2,6828.0,1,4,4,9
1249.0,67,1,1896.0,3,4,4,11
1251.0,18,14,13469.0,2,4,4,10
1252.0,205,11,57527.0,4,2,4,10
1253.0,22,32,76493.0,2,2,2,6
1254.0,25,7,3142.0,3,4,4,11
1256.0,200,1,2460.0,4,4,4,12
1258.0,83,4,10560.0,3,4,4,11
1260.0,67,22,26138.0,3,4,4,11
1261.0,268,1,126.0,4,4,4,12
1262.0,34,18,5995.0,3,4,4,11
1266.0,79,2,828.0,3,4,4,11
1267.0,20,41,57391.0,2,2,2,6
1268.0,34,5,7910.0,3,4,4,11
1270.0,24,2,689.0,2,4,4,10
1274.0,3,124,103473.0,1,2,1,4
1275.0,26,47,214489.0,3,1,2,6
1276.0,267,1,2988.0,4,4,4,12
1277.0,27,33,159490.0,3,1,2,6
1278.0,69,10,70566.0,3,2,4,9
1279.0,123,1,876.0,4,4,4,12
1281.0,65,5,3122.0,3,4,4,11
1283.0,22,14,5447.0,2,4,4,10
1285.0,23,6,20724.0,2,4,4,10
1286.0,73,2,1816.0,3,4,4,11
1287.0,44,4,6370.0,3,4,4,11
1288.0,111,3,865.0,4,4,4,12
1289.0,73,1,425.0,3,4,4,11
1291.0,18,18,14565.0,2,4,4,10
1292.0,367,6,9873.0,4,4,4,12
1293.0,7,18,13338.0,1,4,4,9
1294.0,48,19,24035.0,3,4,4,11
1295.0,3,7,3002.0,1,4,4,9
1296.0,12,34,263644.0,2,1,2,5
1299.0,24,28,66309.0,2,2,2,6
1300.0,20,4,2254.0,2,4,4,10
1301.0,5,346,399216.0,1,1,1,3
1302.0,131,2,237.0,4,4,4,12
1303.0,12,21,31489.0,2,4,4,10
1304.0,143,2,1734.0,4,4,4,12
1305.0,82,13,490076.0,3,1,4,8
1306.0,222,1,1640.0,4,4,4,12
1308.0,240,9,18570.0,4,4,4,12
1309.0,11,12,47154.0,2,4,4,10
1310.0,70,3,7340.0,3,4,4,11
1312.0,15,8,24006.0,2,4,4,10
1314.0,47,12,16922.0,3,4,4,11
1315.0,81,1,1680.0,3,4,4,11
1316.0,335,1,3312.0,4,4,4,12
1317.0,26,8,26078.0,3,4,4,11
1320.0,36,10,24684.0,3,4,4,11
1322.0,29,17,32532.0,3,4,4,11
1326.0,8,5,15960.0,1,4,4,9
1327.0,293,11,7878.0,4,4,4,12
1328.0,8,18,85580.0,1,2,4,7
1329.0,134,1,2532.0,4,4,4,12
1330.0,33,10,19642.0,3,4,4,11
1331.0,68,1,1680.0,3,4,4,11
1332.0,55,1,2808.0,3,4,4,11
1333.0,4,6,16680.0,1,4,4,9
1334.0,83,2,5520.0,3,4,4,11
1335.0,434,3,5070.0,4,4,4,12
1336.0,143,2,3644.0,4,4,4,12
1337.0,74,2,51936.0,3,2,4,9
1338.0,69,24,41367.0,3,4,4,11
1341.0,45,4,4938.0,3,4,4,11
1342.0,39,2,3216.0,3,4,4,11
1343.0,85,6,11432.0,4,4,4,12
1344.0,240,2,3544.0,4,4,4,12
1345.0,272,1,1926.0,4,4,4,12
1346.0,9,141,1287985.0,1,1,1,3
1347.0,170,2,2628.0,4,4,4,12
1348.0,162,1,1420.0,4,4,4,12
1349.0,11,77,31983.0,2,4,1,7
1350.0,216,5,6382.0,4,4,4,12
1352.0,157,2,14652.0,4,4,4,12
1353.0,83,1,3168.0,3,4,4,11
1355.0,162,2,1061.0,4,4,4,12
1356.0,133,2,1212.0,4,4,4,12
1359.0,10,7,18840.0,1,4,4,9
1361.0,41,2,6528.0,3,4,4,11
1362.0,29,33,30299.0,3,4,2,9
1363.0,53,6,2711.0,3,4,4,11
1364.0,111,16,26472.0,4,4,4,12
1365.0,67,3,5386.0,3,4,4,11
1368.0,8,38,102885.0,1,2,2,5
1369.0,4,17,35222.0,1,4,4,9
1371.0,5,51,106585.0,1,2,2,5
1374.0,22,1,1364.0,2,4,4,10
1377.0,4,2,880.0,1,4,4,9
1378.0,266,2,516.0,4,4,4,12
1379.0,243,1,3408.0,4,4,4,12
1382.0,110,4,12363.0,4,4,4,12
1383.0,55,13,22387.0,3,4,4,11
1386.0,35,5,10066.0,3,4,4,11
1387.0,81,6,6432.0,3,4,4,11
1388.0,5,58,213016.0,1,1,2,4
1389.0,3,107,230093.0,1,1,1,3
1390.0,50,12,26476.0,3,4,4,11
1391.0,6,7,13646.0,1,4,4,9
1392.0,46,21,76886.0,3,2,4,9
1393.0,14,194,456172.0,2,1,1,4
1394.0,178,41,96639.0,4,2,2,8
1395.0,11,61,122017.0,2,2,2,6
1396.0,15,118,130636.0,2,2,1,5
1397.0,9,72,281291.0,1,1,2,4
1398.0,27,183,426228.0,3,1,1,5
1399.0,19,43,179117.0,2,1,2,5
1400.0,44,54,101174.0,3,2,2,7
1401.0,14,118,295181.0,2,1,1,4
1402.0,18,36,167446.0,2,1,2,5
1403.0,23,156,115869.0,2,2,1,5
1404.0,13,79,389182.0,2,1,1,4
1405.0,81,15,63854.0,3,2,4,9
1406.0,403,9,17633.0,4,4,4,12
1407.0,329,8,20847.0,4,4,4,12
1408.0,11,115,273718.0,2,1,1,4
1409.0,9,41,103495.0,1,2,2,5
1410.0,44,10,27340.0,3,4,4,11
1411.0,235,16,34381.0,4,4,4,12
1412.0,11,146,302501.0,2,1,1,4
1413.0,15,112,215714.0,2,1,1,4
1414.0,16,75,182781.0,2,1,2,5
1415.0,17,20,15917.0,2,4,4,10
1416.0,293,8,36582.0,4,4,4,12
1417.0,8,109,241426.0,1,1,1,3
1418.0,2,78,382408.0,1,1,1,3
1419.0,264,54,114988.0,4,2,2,8
1420.0,12,107,408531.0,2,1,1,4
1421.0,11,112,1554952.0,2,1,1,4
1422.0,143,5,16202.0,4,4,4,12
1423.0,51,52,139383.0,3,2,2,7
1424.0,9,143,345454.0,1,1,1,3
1425.0,13,19,36422.0,2,4,4,10
1426.0,111,29,62955.0,4,2,2,8
1427.0,74,66,148825.0,3,1,2,6
1428.0,332,29,57851.0,4,2,2,8
1429.0,137,10,15960.0,4,4,4,12
1430.0,81,33,75485.0,3,2,2,7
1431.0,16,29,67670.0,2,2,2,6
1432.0,11,75,132618.0,2,2,2,6
1433.0,15,226,493601.0,2,1,1,4
1434.0,197,8,14544.0,4,4,4,12
1435.0,4,155,487239.0,1,1,1,3
1436.0,9,34,65022.0,1,2,2,5
1437.0,22,27,216966.0,2,1,2,5
1438.0,16,285,696118.0,2,1,1,4
1439.0,69,10,33277.0,3,4,4,11
1440.0,15,17,52158.0,2,2,4,8
1441.0,38,47,104944.0,3,2,2,7
1442.0,21,102,266725.0,2,1,1,4
1443.0,2,238,525477.0,1,1,1,3
1444.0,17,108,551160.0,2,1,1,4
1445.0,4,61,137983.0,1,2,2,5
1446.0,100,6,17356.0,4,4,4,12
1447.0,10,63,179011.0,1,1,2,4
1448.0,5,1634,7870697.0,1,1,1,3
1449.0,19,155,490663.0,2,1,1,4
1450.0,27,3,6260.0,3,4,4,11
1451.0,114,16,88401.0,4,2,4,10
1452.0,45,27,24304.0,3,4,2,9
1453.0,12,110,232408.0,2,1,1,4
1454.0,54,35,252082.0,3,1,2,6
1455.0,15,180,406460.0,2,1,1,4
1456.0,9,123,310204.0,1,1,1,3
1457.0,16,27,27034.0,2,4,2,8
1458.0,11,87,211767.0,2,1,1,4
1459.0,111,8,26668.0,4,4,4,12
1460.0,13,104,294597.0,2,1,1,4
1461.0,40,24,65239.0,3,2,4,9
1462.0,19,42,48067.0,2,4,2,8
1463.0,19,122,261179.0,2,1,1,4
1464.0,75,41,69313.0,3,2,2,7
1465.0,16,9,20787.0,2,4,4,10
1466.0,104,12,37517.0,4,4,4,12
1467.0,17,268,640972.0,2,1,1,4
1468.0,127,28,57222.0,4,2,2,8
1469.0,10,26,110761.0,1,2,4,7
1470.0,10,19,38062.0,1,4,4,9
1471.0,11,162,341844.0,2,1,1,4
1472.0,11,63,67259.0,2,2,2,6
1473.0,17,90,248572.0,2,1,1,4
1474.0,44,34,76075.0,3,2,2,7
1475.0,240,17,35902.0,4,4,4,12
1476.0,45,6,15558.0,3,4,4,11
1477.0,15,129,284158.0,2,1,1,4
1478.0,9,23,81766.0,1,2,4,7
1479.0,12,71,110450.0,2,2,2,6
1480.0,39,6,14778.0,3,4,4,11
1481.0,12,60,127255.0,2,2,2,6
1482.0,264,18,49797.0,4,4,4,12
1483.0,20,31,18220.0,2,4,2,8
1484.0,17,20,34220.0,2,4,4,10
1485.0,257,1,5136.0,4,4,4,12
1486.0,13,47,129929.0,2,2,2,6
1487.0,45,6,13498.0,3,4,4,11
1488.0,6,9,27672.0,1,4,4,9
1489.0,368,11,23380.0,4,4,4,12
1490.0,61,38,78478.0,3,2,2,7
1491.0,50,41,29939.0,3,4,2,9
1492.0,20,58,106546.0,2,2,2,6
1493.0,9,118,269098.0,1,1,1,3
1494.0,23,41,21284.0,2,4,2,8
1495.0,14,69,452903.0,2,1,2,5
1496.0,9,532,1143734.0,1,1,1,3
1497.0,293,8,17560.0,4,4,4,12
1498.0,296,4,11970.0,4,4,4,12
1499.0,359,4,8157.0,4,4,4,12
1500.0,14,75,35113.0,2,4,2,8
1501.0,75,11,66077.0,3,2,4,9
1502.0,50,46,50804.0,3,4,2,9
1503.0,53,55,28495.0,3,4,2,9
1504.0,27,127,104350.0,3,2,1,6
1505.0,10,58,158787.0,1,1,2,4
1506.0,25,14,29451.0,3,4,4,11
1507.0,299,7,17106.0,4,4,4,12
1508.0,9,140,213477.0,1,1,1,3
1509.0,9,191,421159.0,1,1,1,3
1510.0,10,62,136732.0,1,2,2,5
1511.0,9,289,547643.0,1,1,1,3
1512.0,45,5,7542.0,3,4,4,11
1513.0,3,350,424365.0,1,1,1,3
1514.0,10,73,59115.0,1,2,2,5
1515.0,3,95,372035.0,1,1,1,3
1516.0,146,26,78443.0,4,2,4,10
1517.0,5,183,640135.0,1,1,1,3
1518.0,16,26,172065.0,2,1,4,7
1519.0,9,104,192172.0,1,1,1,3
1520.0,121,8,17617.0,4,4,4,12
1521.0,16,75,289254.0,2,1,2,5
1522.0,14,107,347933.0,2,1,1,4
1523.0,12,54,259829.0,2,1,2,5
1524.0,11,285,71297.0,2,2,1,5
1525.0,48,14,117732.0,3,2,4,9
1526.0,9,44,113699.0,1,2,2,5
1527.0,364,23,15742.0,4,4,4,12
1528.0,41,97,282937.0,3,1,1,5
1529.0,2,610,723720.0,1,1,1,3
1530.0,26,14,58676.0,3,2,4,9
1531.0,4,124,278777.0,1,1,1,3
1532.0,10,206,129563.0,1,2,1,4
1533.0,41,30,54767.0,3,2,2,7
1534.0,61,27,99077.0,3,2,2,7
1535.0,1,219,559004.0,1,1,1,3
1536.0,15,3,33816.0,2,4,4,10
1537.0,26,1,34944.0,3,4,4,11
1538.0,9,263,492979.0,1,1,1,3
1539.0,10,17,47024.0,1,4,4,9
1540.0,8,148,147835.0,1,1,1,3
1541.0,18,22,45964.0,2,4,4,10
1542.0,10,382,323693.0,1,1,1,3
1543.0,28,7,92560.0,3,2,4,9
1544.0,11,9,15645.0,2,4,4,10
1545.0,367,5,9228.0,4,4,4,12
1546.0,109,9,18894.0,4,4,4,12
1547.0,293,32,293010.0,4,1,2,7
1548.0,51,55,263435.0,3,1,2,6
1549.0,2,57,161917.0,1,1,2,4
1550.0,8,68,182059.0,1,1,2,4
1551.0,18,98,193153.0,2,1,1,4
1552.0,1,291,146936.0,1,1,1,3
1553.0,20,70,145039.0,2,2,2,6
1554.0,130,20,41384.0,4,4,4,12
1555.0,10,257,125615.0,1,2,1,4
1556.0,181,40,60870.0,4,2,2,8
1557.0,10,109,81945.0,1,2,1,4
1558.0,11,62,32055.0,2,4,2,8
1559.0,14,22,13828.0,2,4,4,10
1560.0,6,973,441542.0,1,1,1,3
1561.0,18,4,15568.0,2,4,4,10
1562.0,13,37,221540.0,2,1,2,5
1563.0,48,17,71583.0,3,2,4,9
1564.0,149,179,253190.0,4,1,1,6
1565.0,12,244,239324.0,2,1,1,4
1566.0,133,6,61795.0,4,2,4,10
1567.0,16,130,128286.0,2,2,1,5
1568.0,9,72,280035.0,1,1,2,4
1569.0,20,90,74019.0,2,2,1,5
1570.0,20,43,57391.0,2,2,2,6
1571.0,14,281,251361.0,2,1,1,4
1572.0,82,7,24418.0,3,4,4,11
1573.0,50,30,59883.0,3,2,2,7
1574.0,14,46,110705.0,2,2,2,6
1575.0,199,19,28023.0,4,4,4,12
1576.0,20,11,175010.0,2,1,4,7
1577.0,77,18,38428.0,3,4,4,11
1578.0,20,12,30384.0,2,4,4,10
1579.0,135,30,90227.0,4,2,2,8
1580.0,9,144,287824.0,1,1,1,3
1581.0,78,10,16961.0,3,4,4,11
1582.0,52,14,40440.0,3,4,4,11
1583.0,39,47,19926.0,3,4,2,9
1584.0,11,145,152194.0,2,1,1,4
1585.0,10,49,140106.0,1,2,2,5
1586.0,208,30,62774.0,4,2,2,8
1587.0,176,17,42777.0,4,4,4,12
1588.0,8,123,296979.0,1,1,1,3
1589.0,26,7,19152.0,3,4,4,11
1590.0,52,6,16136.0,3,4,4,11
1591.0,48,19,64204.0,3,2,4,9
1592.0,18,31,58171.0,2,2,2,6
1593.0,44,192,247780.0,3,1,1,5
1594.0,17,193,107896.0,2,2,1,5
1595.0,89,7,42345.0,4,4,4,12
1596.0,44,12,27165.0,3,4,4,11
1597.0,9,628,304495.0,1,1,1,3
1598.0,4,164,452984.0,1,1,1,3
1599.0,16,107,83233.0,2,2,1,5
1600.0,15,799,717064.0,2,1,1,4
1601.0,10,316,237251.0,1,1,1,3
1602.0,17,98,162433.0,2,1,1,4
1603.0,11,57,33235.0,2,4,2,8
1604.0,9,71,166959.0,1,1,2,4
1605.0,14,23,34334.0,2,4,4,10
1606.0,200,18,52989.0,4,2,4,10
1607.0,10,73,139457.0,1,2,2,5
1608.0,10,101,264900.0,1,1,1,3
1609.0,37,18,38560.0,3,4,4,11
1610.0,10,16,35220.0,1,4,4,9
1611.0,5,4,36978.0,1,4,4,9
1612.0,11,17,115313.0,2,2,4,8
1613.0,114,12,40506.0,4,4,4,12
1614.0,17,202,221066.0,2,1,1,4
1615.0,12,297,564411.0,2,1,1,4
1616.0,3,994,860042.0,1,1,1,3
1617.0,9,18,54920.0,1,2,4,7
1618.0,10,228,78496.0,1,2,1,4
1619.0,11,216,370024.0,2,1,1,4
1620.0,108,64,113282.0,4,2,2,8
1621.0,10,63,330088.0,1,1,2,4
1622.0,3,553,516822.0,1,1,1,3
1623.0,10,331,363608.0,1,1,1,3
1624.0,260,19,19192.0,4,4,4,12
1625.0,58,10,41700.0,3,4,4,11
1626.0,40,19,45958.0,3,4,4,11
1627.0,20,32,80631.0,2,2,2,6
1628.0,48,76,123707.0,3,2,2,7
1629.0,15,111,178550.0,2,1,1,4
1630.0,44,5,11411.0,3,4,4,11
1631.0,5,98,325399.0,1,1,1,3
1632.0,25,114,276356.0,3,1,1,5
1633.0,6,412,308702.0,1,1,1,3
1634.0,4,363,514213.0,1,1,1,3
1635.0,155,4,72480.0,4,2,4,10
1636.0,48,56,37940.0,3,4,2,9
1637.0,20,48,99340.0,2,2,2,6
1638.0,20,10,24943.0,2,4,4,10
1639.0,13,58,20448.0,2,4,2,8
1640.0,9,112,109236.0,1,2,1,4
1641.0,20,216,306003.0,2,1,1,4
1642.0,48,21,40579.0,3,4,4,11
1643.0,10,29,39174.0,1,4,2,7
1644.0,10,76,278995.0,1,1,2,4
1645.0,14,68,153574.0,2,1,2,5
1646.0,4,441,537835.0,1,1,1,3
1647.0,11,128,378681.0,2,1,1,4
1648.0,113,4,167200.0,4,1,4,9
1649.0,42,34,175452.0,3,1,2,6
1650.0,3,12,28144.0,1,4,4,9
1651.0,17,28,25610.0,2,4,2,8
1652.0,6,271,341926.0,1,1,1,3
1653.0,14,241,187135.0,2,1,1,4
1654.0,587,1,4392.0,4,4,4,12
1655.0,20,122,104052.0,2,2,1,5
1656.0,4,23,32212.0,1,4,4,9
1657.0,21,17,21507.0,2,4,4,10
1658.0,100,6,15354.0,4,4,4,12
1659.0,6,330,142588.0,1,2,1,4
1660.0,14,101,123354.0,2,2,1,5
1661.0,51,29,20956.0,3,4,2,9
1662.0,17,27,28338.0,2,4,2,8
1663.0,14,384,197528.0,2,1,1,4
1664.0,403,3,4386.0,4,4,4,12
1665.0,15,197,206573.0,2,1,1,4
1666.0,9,163,77064.0,1,2,1,4
1667.0,22,152,79154.0,2,2,1,5
1668.0,8,53,46017.0,1,4,2,7
1669.0,10,102,226026.0,1,1,1,3
1670.0,20,55,116019.0,2,2,2,6
1671.0,50,50,31473.0,3,4,2,9
1672.0,48,25,45334.0,3,4,4,11
1673.0,20,7,27996.0,2,4,4,10
1674.0,47,2,74400.0,3,2,4,9
1675.0,2,2774,1453762.0,1,1,1,3
1676.0,20,80,1453178.0,2,1,1,4
1677.0,5,17,182375.0,1,1,4,6
1678.0,149,3,204930.0,4,1,4,9
1679.0,170,3,43984.0,4,4,4,12
1680.0,20,17,67332.0,2,2,4,8
1681.0,16,22,44495.0,2,4,4,10
1682.0,47,30,50633.0,3,4,2,9
1683.0,2,95,231907.0,1,1,1,3
1684.0,14,20,37654.0,2,4,4,10
1685.0,9,134,107347.0,1,2,1,4
1686.0,60,13,29593.0,3,4,4,11
1687.0,136,57,101211.0,4,2,2,8
1688.0,10,126,340774.0,1,1,1,3
1689.0,48,5,-2353.0,3,4,4,11
1690.0,16,23,73614.0,2,2,4,8
1691.0,5,151,112711.0,1,2,1,4
1692.0,52,40,126712.0,3,2,2,7
1693.0,264,8,16714.0,4,4,4,12
1694.0,267,20,39890.0,4,4,4,12
1695.0,9,28,75005.0,1,2,2,5
1696.0,51,16,53641.0,3,2,4,9
1697.0,12,174,363166.0,2,1,1,4
1698.0,10,113,242480.0,1,1,1,3
1699.0,23,7,16182.0,2,4,4,10
1700.0,63,2,9908.0,3,4,4,11
1701.0,173,34,105934.0,4,2,2,8
1702.0,10,29,89714.0,1,2,2,5
1703.0,13,30,77363.0,2,2,2,6
1704.0,3,2052,35525394.0,1,1,1,3
1705.0,203,30,27552.0,4,4,2,10
1706.0,5,199,191337.0,1,1,1,3
1707.0,10,102,83133.0,1,2,1,4
1708.0,81,29,13846.0,3,4,2,9
1709.0,2,235,245553.0,1,1,1,3
1710.0,7,48,245483.0,1,1,2,4
1711.0,47,80,35462.0,3,4,1,8
1712.0,13,127,106397.0,2,2,1,5
1713.0,6,29,26782.0,1,4,2,7
1714.0,9,258,302009.0,1,1,1,3
1715.0,87,30,41033.0,4,4,2,10
1716.0,27,4,12447.0,3,4,4,11
1717.0,9,167,106539.0,1,2,1,4
1718.0,9,99,86035.0,1,2,1,4
1719.0,10,114,143217.0,1,2,1,4
1720.0,25,13,26097.0,3,4,4,11
1721.0,9,574,1177996.0,1,1,1,3
1722.0,19,169,167164.0,2,1,1,4
1723.0,17,132,56488.0,2,2,1,5
1724.0,19,61,100905.0,2,2,2,6
1725.0,4,70,217667.0,1,1,2,4
1726.0,20,102,79289.0,2,2,1,5
1727.0,32,44,379844.0,3,1,2,6
1728.0,372,1,-315.0,4,4,4,12
1729.0,11,314,3423657.0,2,1,1,4
1730.0,216,7,53090.0,4,2,4,10
1731.0,105,2,9472.0,4,4,4,12
1732.0,15,421,165839.0,2,1,1,4
1733.0,111,15,81994.0,4,2,4,10
1734.0,8,358,684289.0,1,1,1,3
1735.0,209,13,15043.0,4,4,4,12
1736.0,13,54,44825.0,2,4,2,8
1737.0,9,68,233474.0,1,1,2,4
1738.0,142,69,73629.0,4,2,2,8
1739.0,265,8,18819.0,4,4,4,12
1740.0,5,133,302655.0,1,1,1,3
1741.0,15,22,30584.0,2,4,4,10
1742.0,2,210,156588.0,1,1,1,3
1743.0,76,8,14899.0,3,4,4,11
1744.0,9,115,292277.0,1,1,1,3
1745.0,16,348,292587.0,2,1,1,4
1746.0,2,344,401693.0,1,1,1,3
1747.0,20,22,39919.0,2,4,4,10
1748.0,20,414,207627.0,2,1,1,4
1749.0,258,1,25300.0,4,4,4,12
1750.0,3,29,134183.0,1,2,2,5
1751.0,9,197,611321.0,1,1,1,3
1752.0,10,139,79226.0,1,2,1,4
1753.0,11,357,329152.0,2,1,1,4
1754.0,31,23,88963.0,3,2,4,9
1755.0,9,339,337313.0,1,1,1,3
1756.0,26,10,20408.0,3,4,4,11
1757.0,26,70,110281.0,3,2,2,7
1758.0,50,54,66904.0,3,2,2,7
1759.0,2,238,213175.0,1,1,1,3
1760.0,7,37,77497.0,1,2,2,5
1761.0,148,29,23305.0,4,4,2,10
1762.0,9,276,147134.0,1,1,1,3
1763.0,25,52,104020.0,3,2,2,7
1764.0,17,10,30342.0,2,4,4,10
1765.0,403,71,41251.0,4,4,2,10
1766.0,2,499,257978.0,1,1,1,3
1767.0,15,45,51641.0,2,2,2,6
1768.0,9,149,349768.0,1,1,1,3
1769.0,18,216,1130843.0,2,1,1,4
1770.0,5,204,692945.0,1,1,1,3
1771.0,8,17,136049.0,1,2,4,7
1772.0,40,56,158793.0,3,1,2,6
1773.0,5,61,586519.0,1,1,2,4
1774.0,44,93,177128.0,3,1,1,5
1775.0,20,59,184082.0,2,1,2,5
1776.0,21,28,139752.0,2,2,2,6
1777.0,14,70,165543.0,2,1,2,5
1778.0,16,19,33388.0,2,4,4,10
1779.0,9,90,188461.0,1,1,1,3
1780.0,50,5,48988.0,3,4,4,11
1781.0,88,30,66570.0,4,2,2,8
1782.0,50,40,84460.0,3,2,2,7
1783.0,19,234,594558.0,2,1,1,4
1784.0,20,37,96763.0,2,2,2,6
1785.0,81,19,48678.0,3,4,4,11
1786.0,137,71,171479.0,4,1,2,7
1787.0,5,101,188747.0,1,1,1,3
1788.0,297,7,6498.0,4,4,4,12
1789.0,19,10,30150.0,2,4,4,10
1790.0,264,21,42948.0,4,4,4,12
1791.0,51,7,29355.0,3,4,4,11
1792.0,9,39,32587.0,1,4,2,7
1793.0,15,137,306670.0,2,1,1,4
1794.0,21,6,17512.0,2,4,4,10
1795.0,3,1091,1439731.0,1,1,1,3
1796.0,234,52,112967.0,4,2,2,8
1797.0,114,9,18474.0,4,4,4,12
1798.0,59,60,168226.0,3,1,2,6
1799.0,15,134,347155.0,2,1,1,4
1800.0,191,3,-2451.0,4,4,4,12
1801.0,12,35,91192.0,2,2,2,6
1802.0,17,41,43206.0,2,4,2,8
1803.0,55,27,59968.0,3,2,2,7
1804.0,293,6,21854.0,4,4,4,12
1805.0,27,15,44303.0,3,4,4,11
1806.0,22,3,12216.0,2,4,4,10
1807.0,8,30,83272.0,1,2,2,5
1808.0,30,6,26712.0,3,4,4,11
1809.0,9,46,111524.0,1,2,2,5
1810.0,40,4,-49.0,3,4,4,11
1811.0,22,14,23408.0,2,4,4,10
1812.0,3,82,161323.0,1,1,1,3
1813.0,173,6,14052.0,4,4,4,12
1814.0,2,1164,1095514.0,1,1,1,3
1815.0,54,12,24504.0,3,4,4,11
1816.0,52,13,22090.0,3,4,4,11
1817.0,19,392,595883.0,2,1,1,4
1818.0,10,59,29522.0,1,4,2,7
1819.0,17,44,107256.0,2,2,2,6
1820.0,38,12,42045.0,3,4,4,11
1821.0,20,45,58657.0,2,2,2,6
1822.0,82,11,35983.0,3,4,4,11
1823.0,13,254,343898.0,2,1,1,4
1824.0,18,255,258425.0,2,1,1,4
1825.0,370,30,18153.0,4,4,2,10
1826.0,10,53,114256.0,1,2,2,5
1827.0,205,4,27391.0,4,4,4,12
1828.0,17,63,139899.0,2,2,2,6
1829.0,81,48,81716.0,3,2,2,7
1830.0,66,13,34354.0,3,4,4,11
1831.0,23,29,64970.0,2,2,2,6
1832.0,369,2,5468.0,4,4,4,12
1833.0,136,70,36502.0,4,4,2,10
1834.0,9,28,140976.0,1,2,2,5
1835.0,5,121,270697.0,1,1,1,3
1836.0,110,16,273640.0,4,1,4,9
1837.0,14,45,84396.0,2,2,2,6
1838.0,54,39,27858.0,3,4,2,9
1839.0,10,70,212747.0,1,1,2,4
1840.0,9,6,12428.0,1,4,4,9
1841.0,11,110,232645.0,2,1,1,4
1842.0,268,4,7944.0,4,4,4,12
1843.0,10,138,421070.0,1,1,1,3
1844.0,9,156,326794.0,1,1,1,3
1845.0,10,130,407812.0,1,1,1,3
1846.0,149,13,38098.0,4,4,4,12
1847.0,9,392,1067830.0,1,1,1,3
1848.0,48,22,46346.0,3,4,4,11
1849.0,25,28,70133.0,3,2,2,7
1850.0,11,142,370729.0,2,1,1,4
1851.0,25,10,50401.0,3,4,4,11
1852.0,17,129,370095.0,2,1,1,4
1853.0,120,20,79087.0,4,2,4,10
1854.0,37,66,166372.0,3,1,2,6
1855.0,10,61,140182.0,1,2,2,5
1856.0,20,59,164108.0,2,1,2,5
1857.0,20,12,25886.0,2,4,4,10
1858.0,54,5,16714.0,3,4,4,11
1859.0,26,47,114516.0,3,2,2,7
1860.0,9,11,32664.0,1,4,4,9
1861.0,283,4,14376.0,4,4,4,12
1862.0,10,99,1665383.0,1,1,1,3
1863.0,15,37,84926.0,2,2,2,6
1864.0,4,145,359734.0,1,1,1,3
1865.0,8,71,98860.0,1,2,2,5
1866.0,264,13,38863.0,4,4,4,12
1867.0,4,97,60421.0,1,2,1,4
1868.0,211,28,61344.0,4,2,2,8
1869.0,111,49,172058.0,4,1,2,7
1870.0,20,124,182933.0,2,1,1,4
1871.0,14,47,89447.0,2,2,2,6
1872.0,20,16,35760.0,2,4,4,10
1873.0,27,11,68888.0,3,2,4,9
1874.0,21,54,117271.0,2,2,2,6
1875.0,73,15,127664.0,3,2,4,9
1876.0,46,18,44708.0,3,4,4,11
1877.0,81,6,227500.0,3,1,4,8
1878.0,209,20,45946.0,4,4,4,12
1879.0,19,10,19230.0,2,4,4,10
1880.0,107,7,14797.0,4,4,4,12
1881.0,14,33,81711.0,2,2,2,6
1882.0,20,73,165351.0,2,1,2,5
1883.0,86,22,69947.0,4,2,4,10
1884.0,8,506,1341649.0,1,1,1,3
1885.0,206,43,62817.0,4,2,2,8
1886.0,8,55,157640.0,1,1,2,4
1887.0,18,119,176957.0,2,1,1,4
1888.0,9,97,162670.0,1,1,1,3
1889.0,23,24,44446.0,2,4,4,10
1890.0,12,364,355128.0,2,1,1,4
1891.0,3,69,205535.0,1,1,2,4
1892.0,74,18,71935.0,3,2,4,9
1893.0,4,166,418394.0,1,1,1,3
1894.0,82,9,33220.0,3,4,4,11
1895.0,5,35,46789.0,1,4,2,7
1896.0,2,5860,17699881.0,1,1,1,3
1897.0,16,28,134597.0,2,2,2,6
1898.0,9,87,203156.0,1,1,1,3
1899.0,47,11,24813.0,3,4,4,11
1900.0,11,79,182965.0,2,1,1,4
1901.0,43,45,200035.0,3,1,2,6
1902.0,15,57,127024.0,2,2,2,6
1903.0,9,78,184820.0,1,1,1,3
1904.0,51,44,100311.0,3,2,2,7
1905.0,16,10,35083.0,2,4,4,10
1906.0,9,11,30142.0,1,4,4,9
1907.0,17,128,299868.0,2,1,1,4
1908.0,6,37,98067.0,1,2,2,5
1909.0,366,16,37608.0,4,4,4,12
1910.0,17,88,242572.0,2,1,1,4
1911.0,298,10,237285.0,4,1,4,9
1912.0,9,366,1013832.0,1,1,1,3
1913.0,42,35,181857.0,3,1,2,6
1914.0,9,172,713542.0,1,1,1,3
1915.0,283,3,11822.0,4,4,4,12
1916.0,73,14,37871.0,3,4,4,11
1917.0,11,64,143507.0,2,2,2,6
1918.0,20,20,42862.0,2,4,4,10
1919.0,81,20,44123.0,3,4,4,11
1920.0,10,148,949314.0,1,1,1,3
1921.0,26,55,39827.0,3,4,2,9
1922.0,20,85,40285.0,2,4,1,7
1923.0,77,12,8192.0,3,4,4,11
1924.0,14,42,55050.0,2,2,2,6
1925.0,15,61,91303.0,2,2,2,6
1926.0,38,27,35091.0,3,4,2,9
1927.0,11,316,874912.0,2,1,1,4
1928.0,275,5,14892.0,4,4,4,12
1929.0,9,198,197688.0,1,1,1,3
1930.0,16,13,30522.0,2,4,4,10
1931.0,11,83,77772.0,2,2,1,5
1932.0,20,37,27706.0,2,4,2,8
1933.0,50,5,45472.0,3,4,4,11
1934.0,9,37,20005.0,1,4,2,7
1935.0,10,34,170536.0,1,1,2,4
1936.0,9,160,141602.0,1,2,1,4
1937.0,12,18,12656.0,2,4,4,10
1938.0,111,32,145021.0,4,2,2,8
1939.0,9,21,13343.0,1,4,4,9
1940.0,58,11,44453.0,3,4,4,11
1941.0,17,71,85994.0,2,2,2,6
1942.0,81,215,220745.0,3,1,1,5
1943.0,16,8,14037.0,2,4,4,10
1944.0,20,41,24536.0,2,4,2,8
1945.0,203,87,44037.0,4,4,1,9
1946.0,252,4,39520.0,4,4,4,12
1947.0,212,40,38888.0,4,4,2,10
1948.0,17,61,28207.0,2,4,2,8
1949.0,53,27,97128.0,3,2,2,7
1950.0,174,75,57030.0,4,2,2,8
1951.0,50,77,61836.0,3,2,1,6
1952.0,19,115,207117.0,2,1,1,4
1953.0,148,157,154257.0,4,1,1,6
1954.0,9,1155,824837.0,1,1,1,3
1955.0,52,143,64325.0,3,2,1,6
1956.0,13,12,19567.0,2,4,4,10
1957.0,20,182,156327.0,2,1,1,4
1958.0,9,20,41673.0,1,4,4,9
1959.0,54,128,53611.0,3,2,1,6
1960.0,50,35,31470.0,3,4,2,9
1961.0,173,20,20341.0,4,4,4,12
1962.0,9,20,16507.0,1,4,4,9
1963.0,39,32,52887.0,3,2,2,7
1964.0,267,70,34324.0,4,4,2,10
1965.0,13,479,230504.0,2,1,1,4
1966.0,20,134,116124.0,2,2,1,5
1967.0,4,561,818260.0,1,1,1,3
1968.0,9,155,214095.0,1,1,1,3
1969.0,9,72,47060.0,1,4,2,7
1970.0,17,60,57100.0,2,2,2,6
1971.0,35,36,120920.0,3,2,2,7
1972.0,50,48,83653.0,3,2,2,7
1973.0,163,7,67824.0,4,2,4,10
1974.0,5,111,89927.0,1,2,1,4
1975.0,169,52,640764.0,4,1,2,7
1976.0,5,511,338309.0,1,1,1,3
1977.0,9,400,564893.0,1,1,1,3
1978.0,11,27,41792.0,2,4,2,8
1979.0,81,127,64809.0,3,2,1,6
1980.0,10,132,75029.0,1,2,1,4
1981.0,9,1507,2447373.0,1,1,1,3
1982.0,173,67,23409.0,4,4,2,10
1983.0,204,5,14862.0,4,4,4,12
1984.0,9,3,69200.0,1,2,4,7
1985.0,18,459,903915.0,2,1,1,4
1986.0,13,12,79400.0,2,2,4,8
1987.0,9,205,691786.0,1,1,1,3
1988.0,270,22,47916.0,4,4,4,12
1989.0,10,98,47783.0,1,4,1,6
1990.0,17,3,16431.0,2,4,4,10
1991.0,26,80,227850.0,3,1,1,5
1992.0,24,141,183401.0,2,1,1,4
1993.0,293,30,25828.0,4,4,2,10
1994.0,5,70,122020.0,1,2,2,5
1995.0,20,114,40923.0,2,4,1,7
1996.0,17,25,183502.0,2,1,4,7
1997.0,12,276,272777.0,2,1,1,4
1998.0,15,238,161709.0,2,1,1,4
1999.0,38,120,44703.0,3,4,1,8
2000.0,5,402,5920539.0,1,1,1,3
2001.0,15,57,142597.0,2,2,2,6
2002.0,15,5,38566.0,2,4,4,10
2003.0,9,158,382850.0,1,1,1,3
2004.0,9,52,86816.0,1,2,2,5
2005.0,17,82,221706.0,2,1,1,4
2006.0,50,104,72328.0,3,2,1,6
2007.0,180,70,132737.0,4,2,2,8
2008.0,464,1,12024.0,4,4,4,12
2009.0,11,26,107303.0,2,2,4,8
2010.0,14,76,73437.0,2,2,2,6
2011.0,111,42,93575.0,4,2,2,8
2012.0,81,27,101787.0,3,2,2,7
2013.0,173,49,114768.0,4,2,2,8
2014.0,8,451,1230876.0,1,1,1,3
2015.0,15,48,106611.0,2,2,2,6
2016.0,10,35,56409.0,1,2,2,5
2017.0,230,5,11792.0,4,4,4,12
2018.0,17,15,61264.0,2,2,4,8
2019.0,10,60,138350.0,1,2,2,5
2020.0,11,145,316242.0,2,1,1,4
2021.0,18,23,49854.0,2,4,4,10
2022.0,10,31,66112.0,1,2,2,5
2023.0,15,26,51421.0,2,2,4,8
2024.0,19,111,660568.0,2,1,1,4
2025.0,14,49,194785.0,2,1,2,5
2026.0,50,11,25253.0,3,4,4,11
2027.0,5,25,31944.0,1,4,4,9
2028.0,183,2,95933.0,4,2,4,10
2029.0,85,23,63861.0,4,2,4,10
2030.0,49,5,81794.0,3,2,4,9
2031.0,130,9,35809.0,4,4,4,12
2032.0,9,35,84481.0,1,2,2,5
2033.0,17,71,127985.0,2,2,2,6
2034.0,10,101,290909.0,1,1,1,3
2035.0,10,102,196342.0,1,1,1,3
2036.0,49,19,34245.0,3,4,4,11
2037.0,14,58,140484.0,2,2,2,6
2038.0,16,31,52989.0,2,2,2,6
2039.0,12,40,107838.0,2,2,2,6
2040.0,9,82,183198.0,1,1,1,3
2041.0,27,99,479590.0,3,1,1,5
2042.0,9,197,441490.0,1,1,1,3
2043.0,20,21,40498.0,2,4,4,10
2044.0,21,45,167741.0,2,1,2,5
2045.0,12,80,243860.0,2,1,1,4
2047.0,16,14,30596.0,2,4,4,10
2048.0,134,22,48376.0,4,4,4,12
2049.0,51,28,58497.0,3,2,2,7
2050.0,95,87,200365.0,4,1,1,6
2051.0,8,106,283757.0,1,1,1,3
2052.0,23,15,29692.0,2,4,4,10
2053.0,27,139,1417904.0,3,1,1,5
2054.0,10,16,53359.0,1,2,4,7
2055.0,10,110,207566.0,1,1,1,3
2056.0,12,84,427231.0,2,1,1,4
2057.0,173,22,39328.0,4,4,4,12
2058.0,26,51,127412.0,3,2,2,7
2059.0,73,29,125874.0,3,2,2,7
2060.0,9,73,187540.0,1,1,2,4
2061.0,241,10,14801.0,4,4,4,12
2062.0,4,69,167084.0,1,1,2,4
2063.0,49,13,27166.0,3,4,4,11
2064.0,53,80,320107.0,3,1,1,5
2065.0,50,26,71144.0,3,2,4,9
2066.0,137,14,32266.0,4,4,4,12
2067.0,11,218,804574.0,2,1,1,4
2068.0,16,67,154054.0,2,1,2,5
2069.0,135,95,197608.0,4,1,1,6
2070.0,106,29,77222.0,4,2,2,8
2071.0,20,20,36985.0,2,4,4,10
2072.0,134,23,57265.0,4,2,4,10
2073.0,9,344,731403.0,1,1,1,3
2074.0,9,278,601924.0,1,1,1,3
2075.0,9,22,41338.0,1,4,4,9
2076.0,81,92,28683.0,3,4,1,8
2077.0,3,55,125270.0,1,2,2,5
2078.0,4,132,300532.0,1,1,1,3
2079.0,50,7,51942.0,3,2,4,9
2080.0,4,718,2432139.0,1,1,1,3
2081.0,360,4,18108.0,4,4,4,12
2082.0,20,29,38187.0,2,4,2,8
2083.0,10,102,97840.0,1,2,1,4
2084.0,403,27,56256.0,4,2,2,8
2085.0,321,41,20384.0,4,4,2,10
2086.0,32,5,11940.0,3,4,4,11
2087.0,335,5,142420.0,4,2,4,10
2088.0,38,110,238890.0,3,1,1,5
2089.0,323,11,21408.0,4,4,4,12
2090.0,81,23,40918.0,3,4,4,11
2091.0,265,3,6010.0,4,4,4,12
2092.0,20,95,320112.0,2,1,1,4
2093.0,369,6,10863.0,4,4,4,12
2094.0,10,17,90984.0,1,2,4,7
2095.0,13,29,75781.0,2,2,2,6
2096.0,9,63,50620.0,1,4,2,7
2097.0,71,21,57750.0,3,2,4,9
2098.0,20,19,49221.0,2,4,4,10
2099.0,5,92,552884.0,1,1,1,3
2100.0,3,231,1880310.0,1,1,1,3
2101.0,44,51,152555.0,3,1,2,6
2102.0,10,19,58743.0,1,2,4,7
2103.0,4,324,1042462.0,1,1,1,3
2105.0,20,35,132168.0,2,2,2,6
2106.0,41,10,25048.0,3,4,4,11
2107.0,11,13,137620.0,2,2,4,8
2108.0,12,96,155752.0,2,1,1,4
2109.0,26,142,274224.0,3,1,1,5
2110.0,359,9,49972.0,4,4,4,12
2111.0,12,37,85857.0,2,2,2,6
2112.0,72,9,47454.0,3,4,4,11
2113.0,2,43,102165.0,1,2,2,5
2114.0,137,20,43800.0,4,4,4,12
2115.0,10,52,101157.0,1,2,2,5
2116.0,241,7,11150.0,4,4,4,12
2117.0,324,25,49607.0,4,4,4,12
2118.0,2,109,223381.0,1,1,1,3
2119.0,11,43,71273.0,2,2,2,6
2120.0,93,2,11076.0,4,4,4,12
2121.0,15,166,759560.0,2,1,1,4
2122.0,177,9,32461.0,4,4,4,12
2123.0,17,119,251353.0,2,1,1,4
2124.0,368,10,29830.0,4,4,4,12
2125.0,262,5,75720.0,4,2,4,10
2126.0,16,31,58238.0,2,2,2,6
2127.0,360,16,38446.0,4,4,4,12
2128.0,235,23,51112.0,4,2,4,10
2129.0,18,8,17941.0,2,4,4,10
2130.0,9,58,154037.0,1,1,2,4
2131.0,10,126,464819.0,1,1,1,3
2132.0,241,23,63678.0,4,2,4,10
2133.0,114,31,91496.0,4,2,2,8
2134.0,17,14,31338.0,2,4,4,10
2135.0,15,143,291750.0,2,1,1,4
2136.0,299,15,45703.0,4,4,4,12
2137.0,2,99,196073.0,1,1,1,3
2138.0,11,52,142637.0,2,2,2,6
2139.0,58,52,104417.0,3,2,2,7
2140.0,44,83,229414.0,3,1,1,5
2141.0,10,111,272369.0,1,1,1,3
2142.0,82,22,41500.0,3,4,4,11
2143.0,10,34,79134.0,1,2,2,5
2144.0,14,89,339225.0,2,1,1,4
2145.0,239,33,65006.0,4,2,2,8
2146.0,12,6,43088.0,2,4,4,10
2147.0,9,357,836531.0,1,1,1,3
2148.0,11,121,1355096.0,2,1,1,4
2149.0,9,44,99580.0,1,2,2,5
2150.0,20,55,134430.0,2,2,2,6
2151.0,12,18,45303.0,2,4,4,10
2152.0,10,47,115487.0,1,2,2,5
2153.0,149,6,11513.0,4,4,4,12
2154.0,47,8,25244.0,3,4,4,11
2155.0,15,34,69124.0,2,2,2,6
2156.0,44,78,218736.0,3,1,1,5
2157.0,142,19,38316.0,4,4,4,12
2158.0,324,10,21688.0,4,4,4,12
2159.0,112,12,20580.0,4,4,4,12
2160.0,40,23,53042.0,3,2,4,9
2161.0,13,82,184196.0,2,1,1,4
2162.0,49,6,12736.0,3,4,4,11
2163.0,29,11,206936.0,3,1,4,8
2164.0,24,2,43306.0,2,4,4,10
2165.0,18,48,297226.0,2,1,2,5
2166.0,9,275,312522.0,1,1,1,3
2167.0,58,62,89175.0,3,2,2,7
2168.0,5,47,104517.0,1,2,2,5
2169.0,9,42,83635.0,1,2,2,5
2170.0,10,52,17100.0,1,4,2,7
2171.0,50,12,38679.0,3,4,4,11
2172.0,355,21,41329.0,4,4,4,12
2173.0,173,16,17533.0,4,4,4,12
2174.0,19,149,287963.0,2,1,1,4
2175.0,54,2,19482.0,3,4,4,11
2176.0,23,21,70789.0,2,2,4,8
2177.0,13,88,267623.0,2,1,1,4
2178.0,16,59,145941.0,2,1,2,5
2179.0,5,212,1031503.0,1,1,1,3
2180.0,9,107,541718.0,1,1,1,3
2181.0,203,25,21961.0,4,4,4,12
2182.0,14,199,449922.0,2,1,1,4
2183.0,20,41,77878.0,2,2,2,6
2184.0,3,190,512653.0,1,1,1,3
2185.0,40,7,243469.0,3,1,4,8
2186.0,10,28,64828.0,1,2,2,5
2187.0,14,246,644674.0,2,1,1,4
2188.0,261,31,68949.0,4,2,2,8
2189.0,17,26,72815.0,2,2,4,8
2190.0,10,58,158855.0,1,1,2,4
2191.0,11,12,22403.0,2,4,4,10
2192.0,47,21,39251.0,3,4,4,11
2193.0,1,2489,7966054.0,1,1,1,3
2194.0,15,48,113740.0,2,2,2,6
2195.0,111,1,6800.0,4,4,4,12
2196.0,203,24,46634.0,4,4,4,12
2197.0,10,37,95450.0,1,2,2,5
2198.0,327,1,26300.0,4,4,4,12
2199.0,4,33,69752.0,1,2,2,5
2200.0,47,16,29493.0,3,4,4,11
2201.0,50,36,43453.0,3,4,2,9
2202.0,51,105,319035.0,3,1,1,5
2203.0,65,49,80593.0,3,2,2,7
2204.0,111,49,27496.0,4,4,2,10
2205.0,19,29,54538.0,2,2,2,6
2206.0,53,10,27119.0,3,4,4,11
2207.0,37,60,122167.0,3,2,2,7
2208.0,10,13,110944.0,1,2,4,7
2209.0,370,35,202432.0,4,1,2,7
2210.0,209,16,122592.0,4,2,4,10
2211.0,13,98,49240.0,2,4,1,7
2212.0,54,36,20656.0,3,4,2,9
2213.0,10,87,76729.0,1,2,1,4
2214.0,81,16,234976.0,3,1,4,8
2215.0,42,26,53908.0,3,2,4,9
2216.0,88,21,40730.0,4,4,4,12
2217.0,7,32,52778.0,1,2,2,5
2218.0,36,23,40516.0,3,4,4,11
2219.0,19,17,31193.0,2,4,4,10
2220.0,371,5,29064.0,4,4,4,12
2221.0,163,9,20400.0,4,4,4,12
2222.0,13,72,62239.0,2,2,2,6
2223.0,526,5,14670.0,4,4,4,12
2224.0,9,233,223543.0,1,1,1,3
2225.0,107,63,95772.0,4,2,2,8
2226.0,30,13,29610.0,3,4,4,11
2227.0,9,519,356880.0,1,1,1,3
2228.0,5,561,1183977.0,1,1,1,3
2229.0,70,13,51670.0,3,2,4,9
2230.0,362,7,62856.0,4,2,4,10
2231.0,242,17,42194.0,4,4,4,12
2232.0,11,29,112334.0,2,2,2,6
2233.0,10,149,207044.0,1,1,1,3
2234.0,81,44,85528.0,3,2,2,7
2235.0,16,96,235755.0,2,1,1,4
2236.0,22,4,52590.0,2,2,4,8
2238.0,66,95,282435.0,3,1,1,5
2239.0,142,27,323508.0,4,1,2,7
2240.0,20,137,245662.0,2,1,1,4
2241.0,73,3,17754.0,3,4,4,11
2242.0,45,117,156727.0,3,1,1,5
2243.0,17,196,474067.0,2,1,1,4
2244.0,52,37,189038.0,3,1,2,6
2245.0,220,8,69639.0,4,2,4,10
2246.0,14,306,794296.0,2,1,1,4
2247.0,173,43,86703.0,4,2,2,8
2248.0,50,12,42184.0,3,4,4,11
2249.0,14,31,58259.0,2,2,2,6
2250.0,271,10,17052.0,4,4,4,12
2251.0,181,1,61600.0,4,2,4,10
2252.0,6,85,210873.0,1,1,1,3
2253.0,20,12,32352.0,2,4,4,10
2254.0,69,85,257398.0,3,1,1,5
2255.0,326,7,11703.0,4,4,4,12
2256.0,113,14,35212.0,4,4,4,12
2257.0,261,6,10554.0,4,4,4,12
2258.0,20,73,168460.0,2,1,2,5
2259.0,2,50,112756.0,1,2,2,5
2260.0,12,13,83674.0,2,2,4,8
2261.0,150,41,100352.0,4,2,2,8
2262.0,75,8,47675.0,3,4,4,11
2263.0,18,58,54490.0,2,2,2,6
2264.0,9,152,138668.0,1,2,1,4
2265.0,265,34,33300.0,4,4,2,10
2266.0,12,121,402268.0,2,1,1,4
2267.0,12,100,161750.0,2,1,1,4
2268.0,173,10,25753.0,4,4,4,12
2269.0,9,39,95922.0,1,2,2,5
2270.0,109,48,82235.0,4,2,2,8
2271.0,10,193,505719.0,1,1,1,3
2272.0,86,28,66466.0,4,2,2,8
2273.0,25,8,22032.0,3,4,4,11
2274.0,15,53,123053.0,2,2,2,6
2275.0,328,6,12466.0,4,4,4,12
2276.0,284,2,11010.0,4,4,4,12
2277.0,107,17,52658.0,4,2,4,10
2278.0,9,299,173019.0,1,1,1,3
2279.0,9,305,204939.0,1,1,1,3
2280.0,21,6,17184.0,2,4,4,10
2281.0,27,83,58852.0,3,2,1,6
2282.0,24,10,20764.0,2,4,4,10
2283.0,15,53,65585.0,2,2,2,6
2284.0,33,56,127393.0,3,2,2,7
2285.0,23,29,17200.0,2,4,2,8
2286.0,20,329,143512.0,2,2,1,5
2287.0,264,45,24069.0,4,4,2,10
2288.0,73,25,18738.0,3,4,4,11
2289.0,55,62,47785.0,3,4,2,9
2290.0,169,2,68880.0,4,2,4,10
2291.0,2,381,393491.0,1,1,1,3
2292.0,50,219,181903.0,3,1,1,5
2293.0,267,5,14178.0,4,4,4,12
2294.0,331,9,20334.0,4,4,4,12
2295.0,79,28,62108.0,3,2,2,7
2296.0,14,62,134637.0,2,2,2,6
2297.0,9,30,57288.0,1,2,2,5
2298.0,9,58,67546.0,1,2,2,5
2299.0,2,286,181786.0,1,1,1,3
2300.0,363,25,21555.0,4,4,4,12
2301.0,47,60,70556.0,3,2,2,7
2302.0,264,58,31093.0,4,4,2,10
2303.0,26,7,20568.0,3,4,4,11
2304.0,355,58,25490.0,4,4,2,10
2305.0,11,11,30704.0,2,4,4,10
2306.0,32,7,16688.0,3,4,4,11
2307.0,19,157,121930.0,2,2,1,5
2308.0,17,103,756444.0,2,1,1,4
2309.0,86,57,46159.0,4,4,2,10
2310.0,13,53,66295.0,2,2,2,6
2311.0,51,29,49315.0,3,4,2,9
2312.0,12,26,53901.0,2,2,4,8
2313.0,3,77,60284.0,1,2,1,4
2314.0,114,76,49529.0,4,4,2,10
2315.0,30,11,223736.0,3,1,4,8
2316.0,81,28,59931.0,3,2,2,7
2317.0,50,44,159609.0,3,1,2,6
2318.0,117,45,106810.0,4,2,2,8
2319.0,9,102,1224824.0,1,1,1,3
2320.0,43,88,41207.0,3,4,1,8
2321.0,2,189,518257.0,1,1,1,3
2322.0,9,86,323168.0,1,1,1,3
2323.0,102,2,10728.0,4,4,4,12
2324.0,25,55,139519.0,3,2,2,7
2325.0,15,155,390362.0,2,1,1,4
2326.0,9,35,95370.0,1,2,2,5
2327.0,9,299,224476.0,1,1,1,3
2328.0,12,125,189528.0,2,1,1,4
2329.0,22,16,158300.0,2,1,4,7
2330.0,3,517,1596328.0,1,1,1,3
2331.0,20,68,142643.0,2,2,2,6
2332.0,9,241,842554.0,1,1,1,3
2333.0,363,70,18190.0,4,4,2,10
2334.0,82,13,6892.0,3,4,4,11
2335.0,12,97,488426.0,2,1,1,4
2336.0,23,164,142793.0,2,2,1,5
2337.0,173,46,57368.0,4,2,2,8
2338.0,14,92,124658.0,2,2,1,5
2339.0,333,1,25082.0,4,4,4,12
2340.0,20,160,106323.0,2,2,1,5
2341.0,157,7,16342.0,4,4,4,12
2342.0,9,312,1741019.0,1,1,1,3
2343.0,9,216,472737.0,1,1,1,3
2344.0,50,15,7921.0,3,4,4,11
2345.0,234,27,41934.0,4,4,2,10
2346.0,10,219,256845.0,1,1,1,3
2347.0,2,18,50286.0,1,4,4,9
2348.0,11,198,361867.0,2,1,1,4
2349.0,9,57,76204.0,1,2,2,5
2350.0,85,10,47020.0,4,4,4,12
2351.0,25,1,44112.0,3,4,4,11
2352.0,3,179,100713.0,1,2,1,4
2353.0,36,4,15938.0,3,4,4,11
2354.0,14,165,291298.0,2,1,1,4
2355.0,107,26,31213.0,4,4,4,12
2356.0,10,671,575034.0,1,1,1,3
2357.0,16,108,195167.0,2,1,1,4
2358.0,9,227,250287.0,1,1,1,3
2359.0,26,261,176257.0,3,1,1,5
2360.0,11,86,87396.0,2,2,1,5
2361.0,174,78,53983.0,4,2,1,7
2362.0,104,23,11850.0,4,4,4,12
2363.0,8,41,75117.0,1,2,2,5
2364.0,20,15,33451.0,2,4,4,10
2365.0,115,29,11195.0,4,4,2,10
2366.0,200,28,16815.0,4,4,2,10
2367.0,9,261,501802.0,1,1,1,3
2368.0,55,81,36147.0,3,4,1,8
2369.0,8,702,685901.0,1,1,1,3
2370.0,13,115,192709.0,2,1,1,4
2371.0,5,61,71404.0,1,2,2,5
2372.0,9,29,55464.0,1,2,2,5
2373.0,15,17,11419.0,2,4,4,10
2374.0,10,56,70597.0,1,2,2,5
2375.0,47,14,25982.0,3,4,4,11
2376.0,9,922,695665.0,1,1,1,3
2377.0,25,31,40596.0,3,4,2,9
2378.0,9,19,54064.0,1,2,4,7
2379.0,11,31,85864.0,2,2,2,6
2380.0,357,1,14742.0,4,4,4,12
2381.0,23,114,209842.0,2,1,1,4
2382.0,53,8,21018.0,3,4,4,11
2383.0,20,7,28303.0,2,4,4,10
2384.0,3,50,84263.0,1,2,2,5
2385.0,73,31,182235.0,3,1,2,6
2386.0,9,330,514048.0,1,1,1,3
2387.0,9,57,78096.0,1,2,2,5
2388.0,5,215,318817.0,1,1,1,3
2389.0,9,103,72413.0,1,2,1,4
2390.0,178,168,85977.0,4,2,1,7
2391.0,9,45,113185.0,1,2,2,5
2392.0,13,39,30638.0,2,4,2,8
2393.0,74,13,14765.0,3,4,4,11
2394.0,40,51,40660.0,3,4,2,9
2395.0,13,146,87878.0,2,2,1,5
2396.0,15,44,91714.0,2,2,2,6
2397.0,24,125,89482.0,2,2,1,5
2398.0,177,31,61487.0,4,2,2,8
2399.0,56,9,109452.0,3,2,4,9
2400.0,18,30,55305.0,2,2,2,6
2402.0,50,24,57286.0,3,2,4,9
2403.0,101,5,24156.0,4,4,4,12
2404.0,11,101,222501.0,2,1,1,4
2405.0,15,84,161146.0,2,1,1,4
2406.0,9,23,44097.0,1,4,4,9
2407.0,54,16,31718.0,3,4,4,11
2408.0,28,52,108378.0,3,2,2,7
2409.0,12,414,925902.0,2,1,1,4
2410.0,9,52,167165.0,1,1,2,4
2411.0,87,2,8160.0,4,4,4,12
2412.0,53,17,29769.0,3,4,4,11
2413.0,11,66,142607.0,2,2,2,6
2414.0,10,91,287658.0,1,1,1,3
2415.0,19,13,18096.0,2,4,4,10
2416.0,10,60,145080.0,1,2,2,5
2417.0,14,18,34600.0,2,4,4,10
2418.0,53,6,15752.0,3,4,4,11
2419.0,23,43,186600.0,2,1,2,5
2420.0,63,6,21939.0,3,4,4,11
2421.0,9,426,1285695.0,1,1,1,3
2422.0,9,48,95866.0,1,2,2,5
2423.0,130,3,41200.0,4,4,4,12
2424.0,15,104,205111.0,2,1,1,4
2425.0,5,18,138458.0,1,2,4,7
2426.0,5,214,398393.0,1,1,1,3
2427.0,142,19,35918.0,4,4,4,12
2428.0,117,34,72195.0,4,2,2,8
2429.0,73,68,206702.0,3,1,2,6
2430.0,81,49,112418.0,3,2,2,7
2431.0,5,157,377345.0,1,1,1,3
2432.0,50,61,157207.0,3,1,2,6
2433.0,10,177,423897.0,1,1,1,3
2434.0,20,14,26839.0,2,4,4,10
2435.0,11,25,90636.0,2,2,4,8
2436.0,53,15,30040.0,3,4,4,11
2437.0,307,2,-10680.0,4,4,4,12
2438.0,142,25,57991.0,4,2,4,10
2439.0,5,493,1545333.0,1,1,1,3
2440.0,17,117,262415.0,2,1,1,4
2441.0,17,36,74329.0,2,2,2,6
2442.0,169,238,108545.0,4,2,1,7
2443.0,20,50,71123.0,2,2,2,6
2444.0,13,36,59211.0,2,2,2,6
2445.0,169,27,69374.0,4,2,2,8
2446.0,49,2,88440.0,3,2,4,9
2447.0,9,32,86186.0,1,2,2,5
2448.0,11,21,43839.0,2,4,4,10
2449.0,94,6,155976.0,4,1,4,9
2450.0,29,21,114576.0,3,2,4,9
2451.0,16,37,68935.0,2,2,2,6
2452.0,45,47,93001.0,3,2,2,7
2453.0,26,1,5160.0,3,4,4,11
2454.0,18,56,105920.0,2,2,2,6
2455.0,51,11,35815.0,3,4,4,11
2456.0,27,94,200814.0,3,1,1,5
2457.0,80,5,45748.0,3,4,4,11
2458.0,114,9,20422.0,4,4,4,12
2459.0,51,18,41353.0,3,4,4,11
2460.0,16,116,303601.0,2,1,1,4
2461.0,70,13,39048.0,3,4,4,11
2462.0,220,1,13968.0,4,4,4,12
2463.0,100,35,85208.0,4,2,2,8
2464.0,297,12,21026.0,4,4,4,12
2465.0,11,81,334548.0,2,1,1,4
2466.0,13,155,367569.0,2,1,1,4
2467.0,15,133,237867.0,2,1,1,4
2468.0,13,20,51533.0,2,2,4,8
2469.0,9,216,451567.0,1,1,1,3
2470.0,50,33,84261.0,3,2,2,7
2471.0,53,12,46356.0,3,4,4,11
2472.0,9,110,142836.0,1,2,1,4
2473.0,50,78,182134.0,3,1,1,5
2474.0,9,67,118456.0,1,2,2,5
2475.0,119,10,26987.0,4,4,4,12
2476.0,10,166,355188.0,1,1,1,3
2477.0,121,9,29186.0,4,4,4,12
2478.0,5,19,40776.0,1,4,4,9
2479.0,107,2,15372.0,4,4,4,12
2480.0,9,12,26994.0,1,4,4,9
2481.0,1,78,719118.0,1,1,1,3
2482.0,267,22,51802.0,4,2,4,10
2483.0,9,176,307204.0,1,1,1,3
2484.0,21,18,37754.0,2,4,4,10
2485.0,174,89,82501.0,4,2,1,7
2486.0,3,236,199348.0,1,1,1,3
2487.0,266,5,24768.0,4,4,4,12
2488.0,14,117,280591.0,2,1,1,4
2489.0,203,6,18864.0,4,4,4,12
2490.0,10,59,111470.0,1,2,2,5
2491.0,9,214,124914.0,1,2,1,4
2492.0,45,297,396965.0,3,1,1,5
2493.0,139,6,20033.0,4,4,4,12
2494.0,14,52,115595.0,2,2,2,6
2495.0,144,20,40232.0,4,4,4,12
2496.0,20,35,41596.0,2,4,2,8
2497.0,146,118,158934.0,4,1,1,6
2498.0,239,7,19030.0,4,4,4,12
2499.0,9,937,643420.0,1,1,1,3
2500.0,25,127,73426.0,3,2,1,6
2501.0,20,89,65103.0,2,2,1,5
2502.0,9,72,257542.0,1,1,2,4
2503.0,365,41,24292.0,4,4,2,10
2504.0,108,12,25560.0,4,4,4,12
2505.0,20,31,50498.0,2,4,2,8
2506.0,16,301,676123.0,2,1,1,4
2507.0,52,4,-14575.0,3,4,4,11
2508.0,205,6,7980.0,4,4,4,12
2509.0,40,73,148745.0,3,1,2,6
2510.0,214,14,40426.0,4,4,4,12
2511.0,17,10,18424.0,2,4,4,10
2512.0,115,26,152639.0,4,1,4,9
2513.0,14,81,143854.0,2,2,1,5
2514.0,10,175,618875.0,1,1,1,3
2515.0,40,8,59680.0,3,2,4,9
2516.0,51,9,23444.0,3,4,4,11
2517.0,9,88,88210.0,1,2,1,4
2518.0,85,3,5376.0,4,4,4,12
2519.0,9,62,114939.0,1,2,2,5
2520.0,142,29,23791.0,4,4,2,10
2521.0,12,92,120599.0,2,2,1,5
2522.0,50,21,17550.0,3,4,4,11
2524.0,3,292,327656.0,1,1,1,3
2525.0,11,411,364560.0,2,1,1,4
2526.0,18,1,13968.0,2,4,4,10
2527.0,51,29,55293.0,3,2,2,7
2528.0,3,148,303510.0,1,1,1,3
2529.0,10,192,64540.0,1,2,1,4
2530.0,10,45,95684.0,1,2,2,5
2531.0,26,9,22333.0,3,4,4,11
2532.0,220,7,28544.0,4,4,4,12
2533.0,10,37,70712.0,1,2,2,5
2534.0,9,62,115631.0,1,2,2,5
2535.0,12,188,418511.0,2,1,1,4
2536.0,10,11,39472.0,1,4,4,9
2537.0,116,27,77629.0,4,2,2,8
2538.0,10,117,5044512.0,1,1,1,3
2539.0,7,10,73949.0,1,2,4,7
2540.0,10,25,31453.0,1,4,4,9
2541.0,46,7,14120.0,3,4,4,11
2542.0,134,18,32798.0,4,4,4,12
2543.0,243,22,120164.0,4,2,4,10
2544.0,14,29,58423.0,2,2,2,6
2545.0,18,21,42315.0,2,4,4,10
2546.0,11,43,289770.0,2,1,2,5
2547.0,20,14,40134.0,2,4,4,10
2548.0,9,87,311225.0,1,1,1,3
2549.0,50,280,663374.0,3,1,1,5
2550.0,10,206,123233.0,1,2,1,4
2551.0,359,25,57864.0,4,2,4,10
2552.0,20,34,25649.0,2,4,2,8
2553.0,51,76,194369.0,3,1,2,6
2554.0,21,13,117993.0,2,2,4,8
2555.0,150,42,86463.0,4,2,2,8
2556.0,2,134,310503.0,1,1,1,3
2557.0,18,7,251328.0,2,1,4,7
2558.0,14,97,131562.0,2,2,1,5
2559.0,16,118,86573.0,2,2,1,5
2560.0,10,69,131835.0,1,2,2,5
2562.0,52,8,63054.0,3,2,4,9
2563.0,2,273,540270.0,1,1,1,3
2564.0,10,307,713169.0,1,1,1,3
2565.0,17,31,110694.0,2,2,2,6
2566.0,51,47,103022.0,3,2,2,7
2567.0,18,210,436757.0,2,1,1,4
2568.0,9,43,54787.0,1,2,2,5
2569.0,81,112,152946.0,3,1,1,5
2570.0,22,139,265224.0,2,1,1,4
2571.0,13,41,215951.0,2,1,2,5
2572.0,208,40,164199.0,4,1,2,7
2573.0,9,74,234402.0,1,1,2,4
2574.0,10,49,318572.0,1,1,2,4
2575.0,17,123,256264.0,2,1,1,4
2576.0,293,17,25874.0,4,4,4,12
2577.0,10,62,67494.0,1,2,2,5
2578.0,4,33,109130.0,1,2,2,5
2579.0,19,12,-50372.0,2,4,4,10
2580.0,173,20,64792.0,4,2,4,10
2581.0,55,69,216614.0,3,1,2,6
2582.0,15,133,205765.0,2,1,1,4
2583.0,41,51,106086.0,3,2,2,7
2584.0,9,39,72613.0,1,2,2,5
2585.0,12,69,135280.0,2,2,2,6
2586.0,107,54,106292.0,4,2,2,8
2587.0,17,274,271814.0,2,1,1,4
2588.0,50,50,117711.0,3,2,2,7
2589.0,51,12,12748.0,3,4,4,11
2590.0,10,24,47824.0,1,4,4,9
2591.0,10,161,3243332.0,1,1,1,3
2592.0,9,65,137140.0,1,2,2,5
2593.0,59,28,55309.0,3,2,2,7
2594.0,15,50,168376.0,2,1,2,5
2595.0,18,8,13631.0,2,4,4,10
2596.0,50,11,21384.0,3,4,4,11
2597.0,19,139,456144.0,2,1,1,4
2598.0,39,22,49990.0,3,4,4,11
2599.0,20,97,39319.0,2,4,1,7
2600.0,190,22,19122.0,4,4,4,12
2601.0,52,30,18697.0,3,4,2,9
2602.0,5,139,353911.0,1,1,1,3
2603.0,14,80,96442.0,2,2,1,5
2604.0,5,652,2139358.0,1,1,1,3
2605.0,21,14,47738.0,2,4,4,10
2606.0,10,191,202556.0,1,1,1,3
2607.0,11,141,121247.0,2,2,1,5
2608.0,20,546,446593.0,2,1,1,4
2609.0,38,147,111079.0,3,2,1,6
2610.0,26,18,7833.0,3,4,4,11
2611.0,11,23,270114.0,2,1,4,7
2612.0,15,40,104608.0,2,2,2,6
2613.0,102,45,28855.0,4,4,2,10
2614.0,6,461,481769.0,1,1,1,3
2615.0,17,15,23647.0,2,4,4,10
2616.0,9,76,53659.0,1,2,2,5
2617.0,20,128,48652.0,2,4,1,7
2618.0,10,137,562737.0,1,1,1,3
2619.0,2,130,67674.0,1,2,1,4
2620.0,370,106,43307.0,4,4,1,9
2621.0,79,32,51641.0,3,2,2,7
2622.0,204,23,61366.0,4,2,4,10
2623.0,3,47,49202.0,1,4,2,7
2624.0,11,16,40134.0,2,4,4,10
2625.0,10,12,25046.0,1,4,4,9
2626.0,82,12,16884.0,3,4,4,11
2627.0,13,91,52340.0,2,2,1,5
2628.0,168,61,76084.0,4,2,2,8
2629.0,77,40,33100.0,3,4,2,9
2630.0,150,11,22317.0,4,4,4,12
2631.0,136,24,30997.0,4,4,4,12
2632.0,2,87,167780.0,1,1,1,3
2633.0,369,4,8037.0,4,4,4,12
2634.0,24,49,45390.0,2,4,2,8
2635.0,13,114,57860.0,2,2,1,5
2636.0,9,74,594521.0,1,1,2,4
2637.0,38,30,21842.0,3,4,2,9
2638.0,10,151,178345.0,1,1,1,3
2639.0,4,248,121689.0,1,2,1,4
2640.0,174,7,21188.0,4,4,4,12
2641.0,1,267,173554.0,1,1,1,3
2642.0,179,19,32958.0,4,4,4,12
2643.0,9,159,188150.0,1,1,1,3
2644.0,16,12,13716.0,2,4,4,10
2645.0,44,40,40332.0,3,4,2,9
2646.0,20,143,90570.0,2,2,1,5
2647.0,13,58,21906.0,2,4,2,8
2648.0,173,25,41978.0,4,4,4,12
2649.0,403,12,43694.0,4,4,4,12
2650.0,373,21,21015.0,4,4,4,12
2651.0,167,12,24747.0,4,4,4,12
2652.0,10,21,49673.0,1,4,4,9
2653.0,5,119,372260.0,1,1,1,3
2654.0,22,74,159253.0,2,1,2,5
2655.0,240,11,17226.0,4,4,4,12
2656.0,40,7,17513.0,3,4,4,11
2657.0,117,18,51188.0,4,2,4,10
2658.0,16,77,848097.0,2,1,1,4
2659.0,262,1,3708.0,4,4,4,12
2660.0,134,14,45716.0,4,4,4,12
2661.0,78,6,35718.0,3,4,4,11
2662.0,367,2,19784.0,4,4,4,12
2663.0,83,29,217510.0,3,1,2,6
2664.0,38,60,124346.0,3,2,2,7
2665.0,24,19,48880.0,2,4,4,10
2666.0,6,102,204201.0,1,1,1,3
2667.0,3,43,85894.0,1,2,2,5
2668.0,9,91,102097.0,1,2,1,4
2669.0,10,103,210559.0,1,1,1,3
2670.0,10,185,550667.0,1,1,1,3
2671.0,9,42,53182.0,1,2,2,5
2672.0,82,7,12342.0,3,4,4,11
2673.0,20,28,62196.0,2,2,2,6
2674.0,9,121,104275.0,1,2,1,4
2675.0,24,84,52201.0,2,2,1,5
2676.0,3,21,63546.0,1,2,4,7
2677.0,18,11,37072.0,2,4,4,10
2678.0,22,34,499878.0,2,1,2,5
2679.0,242,5,35737.0,4,4,4,12
2680.0,11,177,450968.0,2,1,1,4
2681.0,85,24,50685.0,4,4,4,12
2682.0,15,98,57370.0,2,2,1,5
2683.0,20,64,158891.0,2,1,2,5
2684.0,81,49,162358.0,3,1,2,6
2685.0,90,42,303554.0,4,1,2,7
2686.0,26,97,445292.0,3,1,1,5
2687.0,23,113,198502.0,2,1,1,4
2688.0,3,275,387237.0,1,1,1,3
2689.0,12,37,164242.0,2,1,2,5
2690.0,31,14,29944.0,3,4,4,11
2691.0,20,140,217497.0,2,1,1,4
2692.0,20,26,19910.0,2,4,4,10
2693.0,50,52,100890.0,3,2,2,7
2694.0,7,3,5044.0,1,4,4,9
2695.0,9,556,369677.0,1,1,1,3
2696.0,55,35,51379.0,3,2,2,7
2697.0,89,131,121921.0,4,2,1,7
2698.0,9,508,411905.0,1,1,1,3
2700.0,9,103,328544.0,1,1,1,3
2701.0,14,218,75929.0,2,2,1,5
2702.0,212,8,16049.0,4,4,4,12
2703.0,10,385,234201.0,1,1,1,3
2704.0,24,33,62454.0,2,2,2,6
2705.0,9,90,116827.0,1,2,1,4
2706.0,16,86,50154.0,2,4,1,7
2707.0,9,212,440700.0,1,1,1,3
2708.0,9,93,179076.0,1,1,1,3
2709.0,5,136,3035863.0,1,1,1,3
2710.0,13,148,78024.0,2,2,1,5
2711.0,4,183,113873.0,1,2,1,4
2712.0,4,233,177655.0,1,1,1,3
2713.0,50,32,26458.0,3,4,2,9
2714.0,100,28,51509.0,4,2,2,8
2715.0,4,163,443593.0,1,1,1,3
2716.0,10,45,108880.0,1,2,2,5
2717.0,264,76,75982.0,4,2,2,8
2718.0,50,101,91172.0,3,2,1,6
2719.0,20,62,47878.0,2,4,2,8
2720.0,30,28,61750.0,3,2,2,7
2721.0,50,32,34846.0,3,4,2,9
2722.0,18,16,147223.0,2,1,4,7
2723.0,10,226,5754682.0,1,1,1,3
2724.0,18,29,44172.0,2,4,2,8
2725.0,11,100,75550.0,2,2,1,5
2726.0,6,1149,1038225.0,1,1,1,3
2727.0,19,22,57229.0,2,2,4,8
2728.0,88,55,113622.0,4,2,2,8
2729.0,18,39,109698.0,2,2,2,6
2730.0,130,28,59242.0,4,2,2,8
2731.0,10,65,164893.0,1,1,2,4
2732.0,33,5,245476.0,3,1,4,8
2733.0,23,75,151874.0,2,1,2,5
2734.0,16,39,101691.0,2,2,2,6
2735.0,16,83,180043.0,2,1,1,4
2736.0,90,9,31384.0,4,4,4,12
2737.0,50,312,145860.0,3,1,1,5
2738.0,175,10,26358.0,4,4,4,12
2739.0,55,34,50292.0,3,4,2,9
2740.0,9,84,230547.0,1,1,1,3
2741.0,146,70,95153.0,4,2,2,8
2742.0,45,8,14489.0,3,4,4,11
2743.0,50,67,81251.0,3,2,2,7
2744.0,7,133,256076.0,1,1,1,3
2745.0,10,180,176559.0,1,1,1,3
2746.0,277,1,-3069.0,4,4,4,12
2747.0,99,64,161666.0,4,1,2,7
2748.0,264,23,46572.0,4,4,4,12
2749.0,366,74,47133.0,4,4,2,10
2750.0,9,100,197401.0,1,1,1,3
2751.0,9,33,105656.0,1,2,2,5
2752.0,51,21,43912.0,3,4,4,11
2753.0,200,23,66708.0,4,2,4,10
2754.0,299,2,12744.0,4,4,4,12
2755.0,4,131,287897.0,1,1,1,3
2756.0,200,1,9376.0,4,4,4,12
2757.0,21,21,169431.0,2,1,4,7
2758.0,82,11,21520.0,3,4,4,11
2759.0,14,227,349151.0,2,1,1,4
2760.0,72,31,175602.0,3,1,2,6
2761.0,300,37,52660.0,4,2,2,8
2762.0,25,167,131409.0,3,2,1,6
2763.0,11,39,128518.0,2,2,2,6
2764.0,43,18,39579.0,3,4,4,11
2765.0,107,53,111718.0,4,2,2,8
2766.0,116,1,2100.0,4,4,4,12
2767.0,9,67,138643.0,1,2,2,5
2768.0,265,12,38200.0,4,4,4,12
2769.0,241,10,23935.0,4,4,4,12
2770.0,12,67,223635.0,2,1,2,5
2771.0,52,39,95948.0,3,2,2,7
2772.0,54,82,162020.0,3,1,1,5
2773.0,12,55,208128.0,2,1,2,5
2774.0,13,48,171170.0,2,1,2,5
2775.0,10,29,37344.0,1,4,2,7
2776.0,16,13,54198.0,2,2,4,8
2777.0,40,6,14724.0,3,4,4,11
2778.0,11,31,371084.0,2,1,2,5
2779.0,85,48,113046.0,4,2,2,8
2780.0,15,18,98340.0,2,2,4,8
2781.0,48,354,170786.0,3,1,1,5
2782.0,19,16,58218.0,2,2,4,8
2783.0,44,30,23673.0,3,4,2,9
2784.0,175,8,15784.0,4,4,4,12
2785.0,15,283,216528.0,2,1,1,4
2786.0,209,35,71521.0,4,2,2,8
2787.0,14,30,30389.0,2,4,2,8
2788.0,69,16,55740.0,3,2,4,9
2789.0,10,32,176695.0,1,1,2,4
2790.0,15,212,114088.0,2,2,1,5
2791.0,113,38,126900.0,4,2,2,8
2792.0,53,15,37066.0,3,4,4,11
2793.0,232,16,20410.0,4,4,4,12
2794.0,368,13,33888.0,4,4,4,12
2795.0,9,117,745905.0,1,1,1,3
2796.0,70,40,84640.0,3,2,2,7
2797.0,9,89,234945.0,1,1,1,3
2798.0,52,78,431200.0,3,1,1,5
2799.0,4,364,1862565.0,1,1,1,3
2800.0,22,38,80239.0,2,2,2,6
2801.0,264,21,61196.0,4,2,4,10
2802.0,60,36,93434.0,3,2,2,7
2803.0,464,1,-831.0,4,4,4,12
2804.0,21,31,78464.0,2,2,2,6
2805.0,10,36,115066.0,1,2,2,5
2806.0,89,29,73741.0,4,2,2,8
2807.0,16,37,73369.0,2,2,2,6
2808.0,4,118,291208.0,1,1,1,3
2809.0,251,1,18160.0,4,4,4,12
2810.0,12,237,521610.0,2,1,1,4
2811.0,166,29,93665.0,4,2,2,8
2812.0,142,22,50301.0,4,4,4,12
2813.0,306,1,14328.0,4,4,4,12
2814.0,6,18,48504.0,1,4,4,9
2815.0,12,136,240588.0,2,1,1,4
2816.0,269,29,222850.0,4,1,2,7
2817.0,44,89,235829.0,3,1,1,5
2818.0,13,136,347872.0,2,1,1,4
2819.0,24,19,90622.0,2,2,4,8
2820.0,47,13,44320.0,3,4,4,11
2821.0,40,22,169222.0,3,1,4,8
2822.0,2,499,660183.0,1,1,1,3
2823.0,169,2,4022.0,4,4,4,12
2824.0,236,6,97873.0,4,2,4,10
2825.0,20,35,101389.0,2,2,2,6
2826.0,12,98,464764.0,2,1,1,4
2827.0,9,85,257999.0,1,1,1,3
2828.0,14,127,263729.0,2,1,1,4
2829.0,61,3,8070.0,3,4,4,11
2830.0,41,69,157257.0,3,1,2,6
2831.0,11,87,170200.0,2,1,1,4
2832.0,13,23,131800.0,2,2,4,8
2833.0,11,58,127367.0,2,2,2,6
2834.0,52,15,38536.0,3,4,4,11
2835.0,142,8,24684.0,4,4,4,12
2836.0,10,11,27602.0,1,4,4,9
2837.0,12,176,1339400.0,2,1,1,4
2838.0,81,11,39478.0,3,4,4,11
2839.0,42,28,855461.0,3,1,2,6
2840.0,10,14,37874.0,1,4,4,9
2841.0,10,46,146796.0,1,1,2,4
2842.0,22,31,65303.0,2,2,2,6
2843.0,10,219,550788.0,1,1,1,3
2844.0,9,295,932437.0,1,1,1,3
2845.0,16,67,140508.0,2,2,2,6
2846.0,20,11,27300.0,2,4,4,10
2847.0,50,6,26436.0,3,4,4,11
2848.0,3,147,648728.0,1,1,1,3
2849.0,237,19,44311.0,4,4,4,12
2850.0,81,14,48552.0,3,4,4,11
2851.0,5,178,134669.0,1,2,1,4
2852.0,4,115,245317.0,1,1,1,3
2853.0,361,18,49208.0,4,4,4,12
2854.0,59,36,70304.0,3,2,2,7
2855.0,24,57,53737.0,2,2,2,6
2856.0,9,97,100801.0,1,2,1,4
2857.0,12,63,69915.0,2,2,2,6
2858.0,26,19,45412.0,3,4,4,11
2859.0,50,66,86813.0,3,2,2,7
2860.0,14,45,147561.0,2,1,2,5
2861.0,3,115,952138.0,1,1,1,3
2862.0,89,24,60294.0,4,2,4,10
2863.0,20,43,77752.0,2,2,2,6
2864.0,83,6,17310.0,3,4,4,11
2865.0,46,44,128257.0,3,2,2,7
2866.0,81,14,29233.0,3,4,4,11
2867.0,268,37,105563.0,4,2,2,8
2868.0,47,18,30543.0,3,4,4,11
2869.0,30,90,401237.0,3,1,1,5
2870.0,9,96,117742.0,1,2,1,4
2871.0,262,137,103734.0,4,2,1,7
2872.0,16,95,190940.0,2,1,1,4
2873.0,17,134,133144.0,2,2,1,5
2874.0,211,8,36966.0,4,4,4,12
2875.0,106,7,32970.0,4,4,4,12
2876.0,88,47,119004.0,4,2,2,8
2877.0,14,35,72124.0,2,2,2,6
2878.0,15,38,124714.0,2,2,2,6
2879.0,81,25,50309.0,3,4,4,11
2880.0,14,47,101045.0,2,2,2,6
2881.0,81,20,52358.0,3,2,4,9
2882.0,14,21,47926.0,2,4,4,10
2883.0,25,142,455525.0,3,1,1,5
2884.0,11,661,334166.0,2,1,1,4
2885.0,9,294,455729.0,1,1,1,3
2886.0,9,51,46405.0,1,4,2,7
2887.0,212,91,195538.0,4,1,1,6
2888.0,12,92,174519.0,2,1,1,4
2889.0,173,16,21387.0,4,4,4,12
2890.0,64,7,19650.0,3,4,4,11
2891.0,53,69,221259.0,3,1,2,6
2892.0,264,24,50692.0,4,4,4,12
2893.0,367,21,-38138.0,4,4,4,12
2894.0,10,123,529764.0,1,1,1,3
2895.0,16,274,331835.0,2,1,1,4
2896.0,260,14,104010.0,4,2,4,10
2897.0,177,2,4859.0,4,4,4,12
2898.0,15,135,670301.0,2,1,1,4
2899.0,51,17,114697.0,3,2,4,9
2900.0,16,124,91129.0,2,2,1,5
2901.0,361,3,-3268.0,4,4,4,12
2902.0,13,260,660555.0,2,1,1,4
2903.0,81,61,106260.0,3,2,2,7
2904.0,81,44,90973.0,3,2,2,7
2905.0,354,54,146451.0,4,1,2,7
2906.0,8,133,190209.0,1,1,1,3
2907.0,117,25,56421.0,4,2,4,10
2908.0,403,65,41179.0,4,4,2,10
2909.0,197,33,77529.0,4,2,2,8
2910.0,177,6,110868.0,4,2,4,10
2911.0,11,25,59477.0,2,2,4,8
2912.0,22,109,204098.0,2,1,1,4
2913.0,82,17,257648.0,3,1,4,8
2914.0,49,11,22909.0,3,4,4,11
2915.0,7,167,213834.0,1,1,1,3
2916.0,9,109,103808.0,1,2,1,4
2917.0,174,8,18412.0,4,4,4,12
2918.0,12,19,37601.0,2,4,4,10
2919.0,22,119,270628.0,2,1,1,4
2920.0,10,79,182104.0,1,1,1,3
2921.0,46,22,37304.0,3,4,4,11
2922.0,23,27,69082.0,2,2,2,6
2923.0,12,12,28954.0,2,4,4,10
2924.0,19,166,648586.0,2,1,1,4
2925.0,142,22,49172.0,4,4,4,12
2926.0,18,44,84965.0,2,2,2,6
2927.0,264,1,37000.0,4,4,4,12
2928.0,41,44,89621.0,3,2,2,7
2929.0,20,37,80726.0,2,2,2,6
2930.0,5,16,39061.0,1,4,4,9
2931.0,331,14,26600.0,4,4,4,12
2932.0,10,155,361868.0,1,1,1,3
2933.0,43,69,179956.0,3,1,2,6
2934.0,9,19,43982.0,1,4,4,9
2935.0,15,3,43056.0,2,4,4,10
2936.0,15,56,136474.0,2,2,2,6
2937.0,81,16,29088.0,3,4,4,11
2938.0,2,37,45861.0,1,4,2,7
2939.0,228,1,23750.0,4,4,4,12
2940.0,12,118,55678.0,2,2,1,5
2941.0,13,20,62464.0,2,2,4,8
2942.0,6,319,341812.0,1,1,1,3
2943.0,20,318,525295.0,2,1,1,4
2944.0,20,41,27606.0,2,4,2,8
2945.0,9,153,197840.0,1,1,1,3
2946.0,17,30,1448208.0,2,1,2,5
2947.0,37,10,20362.0,3,4,4,11
2948.0,13,11,27120.0,2,4,4,10
2949.0,78,20,11915.0,3,4,4,11
2950.0,111,153,81573.0,4,2,1,7
2951.0,25,84,255185.0,3,1,1,5
2952.0,84,15,40997.0,3,4,4,11
2953.0,20,47,47644.0,2,4,2,8
2954.0,13,2,10674.0,2,4,4,10
2955.0,50,37,71519.0,3,2,2,7
2956.0,20,89,102679.0,2,2,1,5
2957.0,9,233,193912.0,1,1,1,3
2958.0,292,9,5798.0,4,4,4,12
2959.0,10,60,134881.0,1,2,2,5
2960.0,19,8,20380.0,2,4,4,10
2961.0,9,28,64118.0,1,2,2,5
2962.0,9,93,760534.0,1,1,1,3
2963.0,65,39,46831.0,3,4,2,9
2964.0,17,32,25595.0,2,4,2,8
2965.0,9,34,78984.0,1,2,2,5
2966.0,2,109,260733.0,1,1,1,3
2967.0,8,68,229316.0,1,1,2,4
2968.0,5,671,443772.0,1,1,1,3
2969.0,25,106,111914.0,3,2,1,6
2970.0,10,85,75003.0,1,2,1,4
2971.0,55,5,14180.0,3,4,4,11
2972.0,20,53,83408.0,2,2,2,6
2973.0,22,51,179530.0,2,1,2,5
2974.0,21,18,48036.0,2,4,4,10
2975.0,9,130,110631.0,1,2,1,4
2976.0,3,76,62530.0,1,2,2,5
2977.0,20,116,204424.0,2,1,1,4
2978.0,14,228,163300.0,2,1,1,4
2979.0,9,97,45106.0,1,4,1,6
2980.0,10,110,57238.0,1,2,1,4
2981.0,20,127,135718.0,2,2,1,5
2982.0,268,4,88140.0,4,2,4,10
2983.0,18,23,51182.0,2,2,4,8
2984.0,5,109,287498.0,1,1,1,3
2985.0,10,31,163178.0,1,1,2,4
2986.0,81,101,85400.0,3,2,1,6
2987.0,11,33,72480.0,2,2,2,6
2988.0,10,59,69213.0,1,2,2,5
2989.0,9,88,42015.0,1,4,1,6
2990.0,329,4,13168.0,4,4,4,12
2991.0,54,35,219191.0,3,1,2,6
2992.0,270,45,32780.0,4,4,2,10
2993.0,3,358,371895.0,1,1,1,3
2994.0,46,100,278652.0,3,1,1,5
2995.0,10,209,223993.0,1,1,1,3
2996.0,13,86,205444.0,2,1,1,4
2997.0,20,72,54448.0,2,2,2,6
2998.0,11,29,41275.0,2,4,2,8
2999.0,2,197,601766.0,1,1,1,3
3000.0,268,60,39584.0,4,4,2,10
3001.0,48,15,20029.0,3,4,4,11
3002.0,101,22,52660.0,4,2,4,10
3003.0,48,5,33756.0,3,4,4,11
3004.0,20,62,23362.0,2,4,2,8
3005.0,16,172,273686.0,2,1,1,4
3006.0,9,232,273260.0,1,1,1,3
3007.0,20,45,27448.0,2,4,2,8
3008.0,54,35,18987.0,3,4,2,9
3009.0,57,31,34447.0,3,4,2,9
3010.0,23,7,14333.0,2,4,4,10
3011.0,50,54,29210.0,3,4,2,9
3012.0,27,72,136687.0,3,2,2,7
3013.0,11,102,80862.0,2,2,1,5
3014.0,12,52,121764.0,2,2,2,6
3015.0,9,380,5094946.0,1,1,1,3
3016.0,25,18,44294.0,3,4,4,11
3017.0,110,6,12170.0,4,4,4,12
3018.0,18,21,43146.0,2,4,4,10
3019.0,3,372,256284.0,1,1,1,3
3020.0,108,9,30820.0,4,4,4,12
3021.0,85,1,-382.0,4,4,4,12
3022.0,111,2,28507.0,4,4,4,12
3023.0,59,6,34727.0,3,4,4,11
3024.0,15,83,85782.0,2,2,1,5
3025.0,10,8,45888.0,1,4,4,9
3026.0,9,17,25517.0,1,4,4,9
3027.0,9,109,193443.0,1,1,1,3
3028.0,6,132,104993.0,1,2,1,4
3029.0,8,279,452228.0,1,1,1,3
3030.0,71,24,46056.0,3,4,4,11
3031.0,2,174,83447.0,1,2,1,4
3032.0,11,85,90760.0,2,2,1,5
3033.0,9,62,28821.0,1,4,2,7
3034.0,212,2,388.0,4,4,4,12
3035.0,142,36,38148.0,4,4,2,10
3036.0,203,20,22390.0,4,4,4,12
3037.0,17,43,84834.0,2,2,2,6
3038.0,151,11,40792.0,4,4,4,12
3039.0,88,14,32861.0,4,4,4,12
3040.0,132,1,734.0,4,4,4,12
3041.0,10,99,229732.0,1,1,1,3
3042.0,18,111,280874.0,2,1,1,4
3043.0,15,9,26288.0,2,4,4,10
3044.0,7,202,458410.0,1,1,1,3
3045.0,30,135,120173.0,3,2,1,6
3046.0,179,33,17486.0,4,4,2,10
3047.0,83,4,10348.0,3,4,4,11
3048.0,9,85,196754.0,1,1,1,3
3049.0,20,234,183859.0,2,1,1,4
3050.0,9,148,199772.0,1,1,1,3
3051.0,83,2,10559.0,3,4,4,11
3052.0,16,181,77642.0,2,2,1,5
3053.0,52,171,99260.0,3,2,1,6
3054.0,17,12,27290.0,2,4,4,10
3055.0,19,19,41747.0,2,4,4,10
3056.0,8,366,224519.0,1,1,1,3
3057.0,17,28,69768.0,2,2,2,6
3058.0,10,145,318781.0,1,1,1,3
3059.0,10,17,43804.0,1,4,4,9
3060.0,20,34,32437.0,2,4,2,8
3061.0,81,53,100727.0,3,2,2,7
3062.0,20,18,39044.0,2,4,4,10
3063.0,75,19,15618.0,3,4,4,11
3064.0,14,26,48715.0,2,4,4,10
3065.0,81,42,46786.0,3,4,2,9
3066.0,9,30,75870.0,1,2,2,5
3067.0,50,39,93821.0,3,2,2,7
3068.0,81,62,184573.0,3,1,2,6
3069.0,297,49,118150.0,4,2,2,8
3070.0,4,97,85755.0,1,2,1,4
3071.0,38,97,206399.0,3,1,1,5
3072.0,19,136,372281.0,2,1,1,4
3073.0,74,16,10769.0,3,4,4,11
3074.0,361,22,37853.0,4,4,4,12
3075.0,8,11,46376.0,1,4,4,9
3076.0,15,86,172300.0,2,1,1,4
3077.0,26,86,75908.0,3,2,1,6
3078.0,9,4,115056.0,1,2,4,7
3079.0,21,3,11112.0,2,4,4,10
3080.0,298,13,39173.0,4,4,4,12
3081.0,373,13,31095.0,4,4,4,12
3082.0,22,168,119251.0,2,2,1,5
3083.0,20,35,109779.0,2,2,2,6
3084.0,11,113,196078.0,2,1,1,4
3085.0,31,6,12046.0,3,4,4,11
3086.0,17,17,20097.0,2,4,4,10
3087.0,10,42,61942.0,1,2,2,5
3088.0,28,12,23637.0,3,4,4,11
3089.0,14,157,133424.0,2,2,1,5
3090.0,2,297,1135256.0,1,1,1,3
3091.0,5,195,1611744.0,1,1,1,3
3092.0,173,15,34920.0,4,4,4,12
3093.0,82,14,27954.0,3,4,4,11
3094.0,4,17,35499.0,1,4,4,9
3095.0,14,30,55492.0,2,2,2,6
3096.0,12,77,168003.0,2,1,1,4
3097.0,145,1,54144.0,4,2,4,10
3098.0,10,179,129252.0,1,2,1,4
3099.0,6,31,81238.0,1,2,2,5
3100.0,111,56,67087.0,4,2,2,8
3101.0,4,45,166627.0,1,1,2,4
3102.0,54,5,13588.0,3,4,4,11
3103.0,173,3,36648.0,4,4,4,12
3104.0,261,26,99651.0,4,2,4,10
3105.0,9,977,528214.0,1,1,1,3
3106.0,14,261,306174.0,2,1,1,4
3107.0,11,32,133577.0,2,2,2,6
3108.0,16,17,47281.0,2,4,4,10
3109.0,17,86,789349.0,2,1,1,4
3110.0,4,73,79502.0,1,2,2,5
3111.0,9,16,34581.0,1,4,4,9
3112.0,10,206,420239.0,1,1,1,3
3113.0,26,11,34969.0,3,4,4,11
3114.0,1,469,1087206.0,1,1,1,3
3115.0,27,58,105616.0,3,2,2,7
3116.0,7,31,65615.0,1,2,2,5
3117.0,54,19,134462.0,3,2,4,9
3118.0,365,3,18035.0,4,4,4,12
3119.0,20,19,77492.0,2,2,4,8
3120.0,19,35,116957.0,2,2,2,6
3121.0,4,5,17489.0,1,4,4,9
3122.0,12,133,461206.0,2,1,1,4
3123.0,4,106,181384.0,1,1,1,3
3124.0,12,58,124323.0,2,2,2,6
3125.0,85,46,84483.0,4,2,2,8
3126.0,81,27,59980.0,3,2,2,7
3127.0,369,1,-3336.0,4,4,4,12
3128.0,14,11,13166.0,2,4,4,10
3129.0,115,6,42924.0,4,4,4,12
3130.0,403,14,28602.0,4,4,4,12
3131.0,82,31,105300.0,3,2,2,7
3132.0,16,8,51949.0,2,2,4,8
3133.0,234,13,27140.0,4,4,4,12
3134.0,43,33,60393.0,3,2,2,7
3135.0,10,9,20960.0,1,4,4,9
3136.0,5,218,537880.0,1,1,1,3
3137.0,44,27,38760.0,3,4,2,9
3138.0,81,52,20732.0,3,4,2,9
3139.0,10,85,54245.0,1,2,1,4
3140.0,21,12,30020.0,2,4,4,10
3141.0,5,7,19356.0,1,4,4,9
3142.0,108,11,18162.0,4,4,4,12
3143.0,5,62,136385.0,1,2,2,5
3144.0,50,29,30993.0,3,4,2,9
3145.0,9,32,65501.0,1,2,2,5
3146.0,11,32,64963.0,2,2,2,6
3147.0,9,172,451543.0,1,1,1,3
3148.0,15,278,662954.0,2,1,1,4
3149.0,106,6,10530.0,4,4,4,12
3150.0,14,11,14447.0,2,4,4,10
3151.0,9,66,146993.0,1,1,2,4
3152.0,71,30,77773.0,3,2,2,7
3153.0,14,26,63119.0,2,2,4,8
3154.0,20,33,69203.0,2,2,2,6
3155.0,236,5,21501.0,4,4,4,12
3156.0,9,97,321352.0,1,1,1,3
3157.0,138,16,25428.0,4,4,4,12
3158.0,6,9,23410.0,1,4,4,9
3159.0,15,29,97077.0,2,2,2,6
3160.0,77,5,15204.0,3,4,4,11
3161.0,81,48,109831.0,3,2,2,7
3162.0,17,23,41551.0,2,4,4,10
3163.0,1,181,560939.0,1,1,1,3
3164.0,83,20,39419.0,3,4,4,11
3165.0,9,119,282697.0,1,1,1,3
3166.0,11,63,63107.0,2,2,2,6
3167.0,20,153,341703.0,2,1,1,4
3168.0,45,9,25108.0,3,4,4,11
3169.0,9,72,153936.0,1,1,2,4
3170.0,24,95,228186.0,2,1,1,4
3171.0,9,52,140722.0,1,2,2,5
3172.0,113,12,33334.0,4,4,4,12
3173.0,5,35,93204.0,1,2,2,5
3174.0,16,27,64363.0,2,2,2,6
3175.0,15,62,124130.0,2,2,2,6
3176.0,173,14,29753.0,4,4,4,12
3177.0,50,21,38324.0,3,4,4,11
3178.0,81,24,70388.0,3,2,4,9
3179.0,15,123,839645.0,2,1,1,4
3180.0,40,76,151704.0,3,1,2,6
3181.0,44,31,73748.0,3,2,2,7
3182.0,9,261,507784.0,1,1,1,3
3183.0,27,80,1344984.0,3,1,1,5
3184.0,24,207,152514.0,2,1,1,4
3185.0,373,8,13708.0,4,4,4,12
3186.0,228,2,8688.0,4,4,4,12
3187.0,20,16,157439.0,2,1,4,7
3188.0,363,9,17591.0,4,4,4,12
3189.0,20,32,23720.0,2,4,2,8
3190.0,10,52,70563.0,1,2,2,5
3191.0,15,20,49638.0,2,4,4,10
3192.0,24,157,176762.0,2,1,1,4
3193.0,9,261,529824.0,1,1,1,3
3194.0,32,6,195229.0,3,1,4,8
3195.0,3,117,955219.0,1,1,1,3
3196.0,11,98,41568.0,2,4,1,7
3197.0,9,92,184540.0,1,1,1,3
3198.0,3,168,425005.0,1,1,1,3
3199.0,403,3,14783.0,4,4,4,12
3200.0,50,10,23316.0,3,4,4,11
3201.0,77,44,246345.0,3,1,2,6
3202.0,5,30,154140.0,1,1,2,4
3203.0,5,269,8102167.0,1,1,1,3
3204.0,10,62,49312.0,1,4,2,7
3205.0,11,588,410836.0,2,1,1,4
3206.0,2,62,165181.0,1,1,2,4
3207.0,82,15,54200.0,3,2,4,9
3208.0,51,13,27336.0,3,4,4,11
3209.0,351,1,875.0,4,4,4,12
3210.0,10,60,60477.0,1,2,2,5
3211.0,15,10,73116.0,2,2,4,8
3212.0,242,21,12778.0,4,4,4,12
3213.0,138,4,143160.0,4,2,4,10
3214.0,9,312,700452.0,1,1,1,3
3215.0,13,153,878911.0,2,1,1,4
3216.0,2,284,1680015.0,1,1,1,3
3217.0,9,123,65414.0,1,2,1,4
3218.0,50,27,80616.0,3,2,2,7
3219.0,16,78,337651.0,2,1,1,4
3220.0,15,399,341642.0,2,1,1,4
3221.0,4,22,209357.0,1,1,4,6
3222.0,11,446,449622.0,2,1,1,4
3223.0,10,629,867198.0,1,1,1,3
3224.0,76,93,148807.0,3,1,1,5
3225.0,81,19,63310.0,3,2,4,9
3226.0,79,2,93600.0,3,2,4,9
3227.0,9,235,399531.0,1,1,1,3
3228.0,370,45,87845.0,4,2,2,8
3229.0,20,203,240432.0,2,1,1,4
3230.0,27,27,24018.0,3,4,2,9
3231.0,264,37,36747.0,4,4,2,10
3232.0,10,228,702806.0,1,1,1,3
3233.0,92,43,72472.0,4,2,2,8
3234.0,18,151,89756.0,2,2,1,5
3235.0,27,185,191539.0,3,1,1,5
3236.0,365,46,35727.0,4,4,2,10
3237.0,50,269,140091.0,3,2,1,6
3238.0,13,663,1014726.0,2,1,1,4
3239.0,53,84,121040.0,3,2,1,6
3240.0,9,28,79455.0,1,2,2,5
3241.0,53,53,86255.0,3,2,2,7
3242.0,11,128,303434.0,2,1,1,4
3243.0,58,1,51552.0,3,2,4,9
3245.0,176,16,37501.0,4,4,4,12
3246.0,52,2,-4064.0,3,4,4,11
3247.0,9,193,323177.0,1,1,1,3
3248.0,9,242,170453.0,1,1,1,3
3249.0,11,358,1034416.0,2,1,1,4
3250.0,5,452,895567.0,1,1,1,3
3251.0,9,45,110847.0,1,2,2,5
3252.0,9,69,201032.0,1,1,2,4
3253.0,42,95,73890.0,3,2,1,6
3254.0,9,24,142053.0,1,2,4,7
3255.0,434,9,23431.0,4,4,4,12
3256.0,59,34,33918.0,3,4,2,9
3258.0,115,176,209496.0,4,1,1,6
3259.0,15,13,30532.0,2,4,4,10
3260.0,262,7,16365.0,4,4,4,12
3261.0,10,22,48816.0,1,4,4,9
3262.0,8,43,105703.0,1,2,2,5
3263.0,11,13,48581.0,2,4,4,10
3264.0,20,86,169338.0,2,1,1,4
3265.0,188,24,80236.0,4,2,4,10
3266.0,4,718,338555.0,1,1,1,3
3267.0,299,1,3552.0,4,4,4,12
3268.0,17,34,145894.0,2,1,2,5
3269.0,9,222,777635.0,1,1,1,3
3270.0,50,58,54933.0,3,2,2,7
3271.0,264,40,41932.0,4,4,2,10
3272.0,58,146,97166.0,3,2,1,6
3273.0,9,254,296617.0,1,1,1,3
3274.0,58,25,25822.0,3,4,4,11
3275.0,10,49,81944.0,1,2,2,5
3276.0,43,157,189830.0,3,1,1,5
3277.0,10,76,50889.0,1,2,2,5
3278.0,81,50,25911.0,3,4,2,9
3279.0,47,16,34442.0,3,4,4,11
3280.0,3,342,1295715.0,1,1,1,3
3281.0,72,60,56899.0,3,2,2,7
3282.0,368,19,34600.0,4,4,4,12
3283.0,9,197,258588.0,1,1,1,3
3284.0,22,3,12000.0,2,4,4,10
3285.0,12,154,75000.0,2,2,1,5
3286.0,130,5,9998.0,4,4,4,12
3287.0,4,94,200453.0,1,1,1,3
3288.0,9,319,206916.0,1,1,1,3
3289.0,17,12,13624.0,2,4,4,10
3290.0,58,16,29688.0,3,4,4,11
3291.0,2,286,168258.0,1,1,1,3
3292.0,366,66,54287.0,4,2,2,8
3293.0,11,18,39270.0,2,4,4,10
3294.0,20,163,144717.0,2,2,1,5
3295.0,17,121,103676.0,2,2,1,5
3296.0,10,24,48005.0,1,4,4,9
3297.0,24,59,65093.0,2,2,2,6
3298.0,174,98,69302.0,4,2,1,7
3299.0,15,102,95733.0,2,2,1,5
3300.0,15,67,150294.0,2,1,2,5
3301.0,17,23,40258.0,2,4,4,10
3302.0,24,150,123997.0,2,2,1,5
3303.0,75,16,34632.0,3,4,4,11
3304.0,5,28,79425.0,1,2,2,5
3305.0,361,15,52538.0,4,2,4,10
3306.0,11,449,256988.0,2,1,1,4
3307.0,13,324,785712.0,2,1,1,4
3308.0,109,27,54168.0,4,2,2,8
3309.0,4,91,182679.0,1,1,1,3
3310.0,11,190,433098.0,2,1,1,4
3311.0,11,26,59751.0,2,2,4,8
3312.0,198,38,42323.0,4,4,2,10
3313.0,20,26,60878.0,2,2,4,8
3314.0,14,28,111816.0,2,2,2,6
3315.0,52,21,38053.0,3,4,4,11
3316.0,113,7,15182.0,4,4,4,12
3317.0,13,11,23474.0,2,4,4,10
3318.0,39,23,45546.0,3,4,4,11
3319.0,14,12,21842.0,2,4,4,10
3320.0,2,46,132655.0,1,2,2,5
3321.0,198,24,60636.0,4,2,4,10
3322.0,134,10,21583.0,4,4,4,12
3323.0,70,11,33315.0,3,4,4,11
3324.0,9,166,396518.0,1,1,1,3
3325.0,200,26,68983.0,4,2,4,10
3326.0,9,292,2007549.0,1,1,1,3
3327.0,9,116,282177.0,1,1,1,3
3328.0,13,64,156323.0,2,1,2,5
3329.0,10,376,1510432.0,1,1,1,3
3330.0,53,11,25652.0,3,4,4,11
3331.0,51,12,23600.0,3,4,4,11
3332.0,53,14,39716.0,3,4,4,11
3333.0,105,8,13967.0,4,4,4,12
3334.0,19,19,42776.0,2,4,4,10
3335.0,8,20,46294.0,1,4,4,9
3336.0,130,9,17285.0,4,4,4,12
3337.0,25,19,39303.0,3,4,4,11
3338.0,23,2,4170.0,2,4,4,10
3339.0,369,13,38147.0,4,4,4,12
3340.0,111,72,84744.0,4,2,2,8
3341.0,10,7,23336.0,1,4,4,9
3342.0,9,28,70264.0,1,2,2,5
3343.0,43,11,24230.0,3,4,4,11
3344.0,23,129,105856.0,2,2,1,5
3345.0,11,139,339755.0,2,1,1,4
3346.0,75,7,93775.0,3,2,4,9
3347.0,5,289,907588.0,1,1,1,3
3348.0,10,122,250283.0,1,1,1,3
3349.0,13,159,108853.0,2,2,1,5
3350.0,26,6,-198.0,3,4,4,11
3351.0,9,178,190440.0,1,1,1,3
3352.0,71,1,46200.0,3,4,4,11
3353.0,10,39,96178.0,1,2,2,5
3354.0,14,38,32996.0,2,4,2,8
3355.0,9,26,58859.0,1,2,4,7
3356.0,20,101,56705.0,2,2,1,5
3357.0,9,37,26010.0,1,4,2,7
3358.0,16,135,204321.0,2,1,1,4
3359.0,2,203,95517.0,1,2,1,4
3360.0,2,101,60981.0,1,2,1,4
3361.0,367,45,17894.0,4,4,2,10
3362.0,10,69,27245.0,1,4,2,7
3363.0,109,44,24198.0,4,4,2,10
3364.0,27,163,59773.0,3,2,1,6
3365.0,8,125,155659.0,1,1,1,3
3366.0,10,78,122219.0,1,2,1,4
3367.0,117,44,203120.0,4,1,2,7
3368.0,9,59,47149.0,1,4,2,7
3369.0,5,708,485455.0,1,1,1,3
3370.0,6,208,381215.0,1,1,1,3
3371.0,16,93,72422.0,2,2,1,5
3372.0,9,151,111196.0,1,2,1,4
3373.0,10,19,48252.0,1,4,4,9
3374.0,5,545,195875.0,1,1,1,3
3375.0,9,103,297579.0,1,1,1,3
3376.0,261,8,14310.0,4,4,4,12
3377.0,9,38,29666.0,1,4,2,7
3378.0,16,57,69155.0,2,2,2,6
3379.0,24,143,81403.0,2,2,1,5
3380.0,17,9,50104.0,2,4,4,10
3381.0,10,130,136356.0,1,2,1,4
3382.0,13,327,330978.0,2,1,1,4
3383.0,10,60,24330.0,1,4,2,7
3384.0,10,692,840541.0,1,1,1,3
3385.0,10,86,93995.0,1,2,1,4
3386.0,373,14,24747.0,4,4,4,12
3387.0,47,6,67238.0,3,2,4,9
3388.0,11,212,382340.0,2,1,1,4
3389.0,4,77,177644.0,1,1,1,3
3390.0,10,54,54681.0,1,2,2,5
3391.0,6,896,622253.0,1,1,1,3
3392.0,54,53,20798.0,3,4,2,9
3393.0,2,49,65348.0,1,2,2,5
3394.0,55,62,115947.0,3,2,2,7
3395.0,26,57,36216.0,3,4,2,9
3396.0,18,240,241304.0,2,1,1,4
3397.0,53,303,414510.0,3,1,1,5
3398.0,9,282,230841.0,1,1,1,3
3399.0,212,33,89272.0,4,2,2,8
3400.0,9,246,572857.0,1,1,1,3
3401.0,236,21,52890.0,4,2,4,10
3402.0,142,18,65920.0,4,2,4,10
3403.0,4,60,168952.0,1,1,2,4
3404.0,12,42,148561.0,2,1,2,5
3405.0,18,87,188035.0,2,1,1,4
3406.0,111,16,21431.0,4,4,4,12
3407.0,32,1,2650.0,3,4,4,11
3408.0,3,54,267687.0,1,1,2,4
3409.0,14,26,59790.0,2,2,4,8
3410.0,21,18,35299.0,2,4,4,10
3411.0,47,16,52214.0,3,2,4,9
3412.0,88,7,14875.0,4,4,4,12
3413.0,10,100,64915.0,1,2,1,4
3414.0,117,14,27795.0,4,4,4,12
3415.0,44,7,12983.0,3,4,4,11
3416.0,168,25,29149.0,4,4,4,12
3417.0,21,30,305937.0,2,1,2,5
3418.0,14,21,48144.0,2,4,4,10
3419.0,6,31,59862.0,1,2,2,5
3420.0,44,42,103922.0,3,2,2,7
3421.0,39,41,39507.0,3,4,2,9
3422.0,270,2,30496.0,4,4,4,12
3423.0,81,39,42687.0,3,4,2,9
3424.0,5,88,205656.0,1,1,1,3
3425.0,138,87,150642.0,4,1,1,6
3426.0,10,22,46490.0,1,4,4,9
3427.0,11,148,256315.0,2,1,1,4
3428.0,42,416,562245.0,3,1,1,5
3429.0,20,121,646880.0,2,1,1,4
3430.0,31,2,9570.0,3,4,4,11
3431.0,4,125,174969.0,1,1,1,3
3432.0,6,7,15299.0,1,4,4,9
3433.0,24,12,186771.0,2,1,4,7
3434.0,45,1,22500.0,3,4,4,11
3435.0,9,94,197270.0,1,1,1,3
3436.0,464,1,-209.0,4,4,4,12
3437.0,9,41,173896.0,1,1,2,4
3438.0,109,12,89960.0,4,2,4,10
3439.0,109,5,30502.0,4,4,4,12
3440.0,26,23,67781.0,3,2,4,9
3441.0,1,169,497679.0,1,1,1,3
3442.0,15,50,184459.0,2,1,2,5
3443.0,11,44,189031.0,2,1,2,5
3444.0,7,42,85058.0,1,2,2,5
3445.0,13,53,121262.0,2,2,2,6
3446.0,21,12,27146.0,2,4,4,10
3447.0,9,15,39090.0,1,4,4,9
3448.0,9,74,69985.0,1,2,2,5
3449.0,9,217,285553.0,1,1,1,3
3450.0,3,268,1178144.0,1,1,1,3
3451.0,50,16,100138.0,3,2,4,9
3452.0,20,233,166537.0,2,1,1,4
3453.0,9,7,11220.0,1,4,4,9
3454.0,41,3,10495.0,3,4,4,11
3455.0,10,9,48318.0,1,4,4,9
3456.0,105,4,21551.0,4,4,4,12
3457.0,78,155,107156.0,3,2,1,6
3458.0,117,2,86000.0,4,2,4,10
3459.0,10,11,19982.0,1,4,4,9
3460.0,13,22,50075.0,2,4,4,10
3461.0,15,28,129116.0,2,2,2,6
3462.0,20,32,92461.0,2,2,2,6
3463.0,18,32,47553.0,2,4,2,8
3464.0,83,76,155086.0,3,1,2,6
3465.0,9,22,12923.0,1,4,4,9
3466.0,143,15,51732.0,4,2,4,10
3467.0,27,71,164007.0,3,1,2,6
3468.0,4,98,155405.0,1,1,1,3
3469.0,9,102,231136.0,1,1,1,3
3470.0,29,10,106861.0,3,2,4,9
3471.0,74,22,40584.0,3,4,4,11
3472.0,13,22,88420.0,2,2,4,8
3473.0,86,64,135143.0,4,2,2,8
3474.0,17,48,112915.0,2,2,2,6
3475.0,3,319,680220.0,1,1,1,3
3476.0,11,316,409514.0,2,1,1,4
3477.0,136,43,33570.0,4,4,2,10
3478.0,9,92,54930.0,1,2,1,4
3479.0,42,14,54197.0,3,2,4,9
3480.0,9,84,178362.0,1,1,1,3
3481.0,82,62,150427.0,3,1,2,6
3482.0,9,515,408405.0,1,1,1,3
3483.0,269,5,37026.0,4,4,4,12
3484.0,45,101,586469.0,3,1,1,5
3485.0,109,70,77554.0,4,2,2,8
3486.0,22,82,179507.0,2,1,1,4
3487.0,14,62,99205.0,2,2,2,6
3489.0,10,296,557246.0,1,1,1,3
3490.0,9,154,341424.0,1,1,1,3
3491.0,115,64,38214.0,4,4,2,10
3492.0,9,147,293606.0,1,1,1,3
3493.0,20,173,182424.0,2,1,1,4
3494.0,20,79,94622.0,2,2,1,5
3495.0,17,25,98993.0,2,2,4,8
3496.0,9,27,73894.0,1,2,2,5
3497.0,82,2,14148.0,3,4,4,11
3498.0,24,9,36288.0,2,4,4,10
3499.0,26,63,31989.0,3,4,2,9
3500.0,9,81,242570.0,1,1,1,3
3501.0,18,52,175036.0,2,1,2,5
3502.0,9,162,371588.0,1,1,1,3
3503.0,12,189,195212.0,2,1,1,4
3504.0,8,96,302762.0,1,1,1,3
3505.0,9,115,242485.0,1,1,1,3
3506.0,7,62,237420.0,1,1,2,4
3507.0,3,196,464280.0,1,1,1,3
3508.0,12,125,235181.0,2,1,1,4
3509.0,323,15,35190.0,4,4,4,12
3510.0,23,76,160559.0,2,1,2,5
3511.0,20,52,115732.0,2,2,2,6
3512.0,3,213,117519.0,1,2,1,4
3513.0,20,65,140644.0,2,2,2,6
3514.0,30,41,190592.0,3,1,2,6
3515.0,271,1,2738.0,4,4,4,12
3516.0,13,90,99140.0,2,2,1,5
3517.0,9,416,1330926.0,1,1,1,3
3518.0,9,121,115892.0,1,2,1,4
3519.0,166,12,18428.0,4,4,4,12
3520.0,50,30,36735.0,3,4,2,9
3521.0,6,135,86081.0,1,2,1,4
3522.0,38,43,99121.0,3,2,2,7
3523.0,200,9,15066.0,4,4,4,12
3524.0,262,10,21850.0,4,4,4,12
3525.0,8,38,79790.0,1,2,2,5
3526.0,234,18,38565.0,4,4,4,12
3527.0,121,7,18804.0,4,4,4,12
3528.0,74,9,47700.0,3,4,4,11
3529.0,14,32,36552.0,2,4,2,8
3530.0,51,39,34876.0,3,4,2,9
3531.0,13,262,133701.0,2,2,1,5
3532.0,19,14,19762.0,2,4,4,10
3533.0,6,134,293614.0,1,1,1,3
3534.0,20,26,515344.0,2,1,4,7
3535.0,116,24,46824.0,4,4,4,12
3536.0,9,52,168425.0,1,1,2,4
3537.0,17,24,45886.0,2,4,4,10
3538.0,10,487,1300356.0,1,1,1,3
3539.0,16,20,56833.0,2,2,4,8
3540.0,241,15,62909.0,4,2,4,10
3541.0,2,48,113009.0,1,2,2,5
3542.0,115,35,85561.0,4,2,2,8
3543.0,23,85,214375.0,2,1,1,4
3544.0,53,9,16358.0,3,4,4,11
3545.0,167,15,181988.0,4,1,4,9
3546.0,25,14,25998.0,3,4,4,11
3547.0,81,23,58420.0,3,2,4,9
3548.0,20,20,34831.0,2,4,4,10
3549.0,174,15,37943.0,4,4,4,12
3550.0,9,67,170044.0,1,1,2,4
3551.0,22,102,211636.0,2,1,1,4
3552.0,9,229,486928.0,1,1,1,3
3553.0,9,105,216049.0,1,1,1,3
3554.0,22,5,32736.0,2,4,4,10
3555.0,9,145,326262.0,1,1,1,3
3556.0,78,10,20484.0,3,4,4,11
3557.0,204,14,22741.0,4,4,4,12
3558.0,14,59,108357.0,2,2,2,6
3559.0,231,16,35107.0,4,4,4,12
3560.0,81,15,47256.0,3,4,4,11
3561.0,6,87,437988.0,1,1,1,3
3562.0,76,4,8702.0,3,4,4,11
3563.0,50,64,183392.0,3,1,2,6
3564.0,203,15,39004.0,4,4,4,12
3565.0,179,80,83655.0,4,2,1,7
3566.0,57,131,106491.0,3,2,1,6
3567.0,58,23,29149.0,3,4,4,11
3568.0,8,73,363451.0,1,1,2,4
3569.0,10,2,22600.0,1,4,4,9
3570.0,168,10,27817.0,4,4,4,12
3571.0,18,86,300580.0,2,1,1,4
3572.0,111,61,48965.0,4,4,2,10
3573.0,59,19,52570.0,3,2,4,9
3574.0,9,237,269897.0,1,1,1,3
3575.0,50,35,238296.0,3,1,2,6
3576.0,361,25,30140.0,4,4,4,12
3577.0,9,29,110989.0,1,2,2,5
3578.0,25,96,89330.0,3,2,1,6
3579.0,54,40,46031.0,3,4,2,9
3580.0,9,152,504079.0,1,1,1,3
3581.0,174,67,158830.0,4,1,2,7
3582.0,54,13,74236.0,3,2,4,9
3583.0,54,7,25752.0,3,4,4,11
3584.0,28,211,288687.0,3,1,1,5
3585.0,169,4,31215.0,4,4,4,12
3586.0,50,162,324291.0,3,1,1,5
3587.0,10,104,111590.0,1,2,1,4
3588.0,236,9,12143.0,4,4,4,12
3589.0,5,274,242206.0,1,1,1,3
3590.0,9,25,16032.0,1,4,4,9
3591.0,12,472,416700.0,2,1,1,4
3592.0,8,63,47719.0,1,4,2,7
3593.0,10,28,41781.0,1,4,2,7
3594.0,18,47,43746.0,2,4,2,8
3595.0,18,21,63759.0,2,2,4,8
3596.0,10,46,129624.0,1,2,2,5
3597.0,10,207,262620.0,1,1,1,3
3598.0,11,47,40371.0,2,4,2,8
3599.0,18,72,440139.0,2,1,2,5
3600.0,10,546,402877.0,1,1,1,3
3601.0,3,36,52623.0,1,2,2,5
3602.0,9,25,24284.0,1,4,4,9
3603.0,14,14,17463.0,2,4,4,10
3604.0,26,29,65579.0,3,2,2,7
3605.0,16,105,111717.0,2,2,1,5
3606.0,23,19,36692.0,2,4,4,10
3607.0,4,564,462661.0,1,1,1,3
3608.0,79,16,45349.0,3,4,4,11
3609.0,111,40,142926.0,4,2,2,8
3610.0,2,398,999834.0,1,1,1,3
3611.0,54,31,125059.0,3,2,2,7
3612.0,205,9,20019.0,4,4,4,12
3613.0,20,55,34357.0,2,4,2,8
3614.0,12,69,41853.0,2,4,2,8
3615.0,4,57,47807.0,1,4,2,7
3616.0,363,39,34116.0,4,4,2,10
3617.0,14,87,47392.0,2,4,1,7
3618.0,20,18,19687.0,2,4,4,10
3619.0,5,112,41254.0,1,4,1,6
3620.0,50,78,39523.0,3,4,1,8
3621.0,79,16,34358.0,3,4,4,11
3622.0,149,124,81337.0,4,2,1,7
3623.0,56,12,142033.0,3,2,4,9
3624.0,209,23,8141.0,4,4,4,12
3625.0,142,127,75707.0,4,2,1,7
3626.0,3,80,39213.0,1,4,1,6
3627.0,12,38,41086.0,2,4,2,8
3628.0,112,6,119844.0,4,2,4,10
3629.0,50,116,303973.0,3,1,1,5
3630.0,9,26,14560.0,1,4,4,9
3631.0,198,69,127709.0,4,2,2,8
3632.0,244,15,33496.0,4,4,4,12
3633.0,61,9,23043.0,3,4,4,11
3634.0,103,94,294747.0,4,1,1,6
3635.0,10,293,231599.0,1,1,1,3
3636.0,22,45,21571.0,2,4,2,8
3637.0,27,124,131400.0,3,2,1,6
3638.0,20,142,205509.0,2,1,1,4
3639.0,9,110,118275.0,1,2,1,4
3640.0,4,102,75445.0,1,2,1,4
3641.0,309,1,59112.0,4,2,4,10
3642.0,9,134,246079.0,1,1,1,3
3643.0,9,69,71118.0,1,2,2,5
3644.0,20,51,16299.0,2,4,2,8
3645.0,102,30,70278.0,4,2,2,8
3646.0,11,57,103398.0,2,2,2,6
3647.0,22,66,27758.0,2,4,2,8
3648.0,9,81,138731.0,1,2,1,4
3649.0,362,53,31581.0,4,4,2,10
3650.0,20,69,1352873.0,2,1,2,5
3652.0,41,12,9806.0,3,4,4,11
3653.0,81,54,182253.0,3,1,2,6
3654.0,43,14,75499.0,3,2,4,9
3655.0,9,27,297480.0,1,1,2,4
3656.0,9,135,355562.0,1,1,1,3
3657.0,2,484,832207.0,1,1,1,3
3658.0,11,11,279774.0,2,1,4,7
3659.0,72,73,152076.0,3,1,2,6
3660.0,10,107,87225.0,1,2,1,4
3661.0,10,203,132306.0,1,2,1,4
3662.0,22,50,142258.0,2,2,2,6
3663.0,17,6,11706.0,2,4,4,10
3664.0,20,32,57194.0,2,2,2,6
3665.0,71,4,22934.0,3,4,4,11
3666.0,128,1,18272.0,4,4,4,12
3667.0,87,28,64371.0,4,2,2,8
3668.0,48,12,45270.0,3,4,4,11
3669.0,16,547,257748.0,2,1,1,4
3670.0,20,753,819051.0,2,1,1,4
3671.0,11,9,32916.0,2,4,4,10
3672.0,9,421,1512454.0,1,1,1,3
3673.0,13,183,101195.0,2,2,1,5
3674.0,357,17,21336.0,4,4,4,12
3675.0,50,32,19825.0,3,4,2,9
3676.0,11,87,71763.0,2,2,1,5
3677.0,4,503,336696.0,1,1,1,3
3678.0,88,1,41688.0,4,4,4,12
3679.0,9,213,187806.0,1,1,1,3
3680.0,180,9,21123.0,4,4,4,12
3681.0,38,72,153223.0,3,1,2,6
3682.0,9,27,65398.0,1,2,2,5
3683.0,104,8,242700.0,4,1,4,9
3684.0,51,16,201487.0,3,1,4,8
3685.0,48,19,27652.0,3,4,4,11
3686.0,25,45,46280.0,3,4,2,9
3687.0,18,59,46656.0,2,4,2,8
3688.0,20,15,24518.0,2,4,4,10
3689.0,14,132,74115.0,2,2,1,5
3690.0,14,29,55733.0,2,2,2,6
3691.0,79,34,41600.0,3,4,2,9
3692.0,1,414,580780.0,1,1,1,3
3693.0,19,466,724035.0,2,1,1,4
3694.0,239,34,22543.0,4,4,2,10
3695.0,19,126,193097.0,2,1,1,4
3696.0,11,33,68102.0,2,2,2,6
3697.0,20,87,48715.0,2,4,1,7
3698.0,10,252,169771.0,1,1,1,3
3699.0,50,57,82826.0,3,2,2,7
3700.0,15,28,52202.0,2,2,2,6
3701.0,79,71,55669.0,3,2,2,7
3702.0,48,24,25873.0,3,4,4,11
3703.0,9,412,495360.0,1,1,1,3
3704.0,20,82,67434.0,2,2,1,5
3705.0,10,105,2807583.0,1,1,1,3
3706.0,10,2,6640.0,1,4,4,9
3707.0,5,51,26550.0,1,4,2,7
3708.0,20,15,38752.0,2,4,4,10
3709.0,20,47,36876.0,2,4,2,8
3710.0,38,27,262856.0,3,1,2,6
3711.0,9,78,105270.0,1,2,1,4
3712.0,73,15,164928.0,3,1,4,8
3713.0,3,220,3332232.0,1,1,1,3
3714.0,174,3,57024.0,4,2,4,10
3715.0,48,61,63483.0,3,2,2,7
3716.0,15,4,22803.0,2,4,4,10
3717.0,40,25,689718.0,3,1,4,8
3718.0,23,92,82670.0,2,2,1,5
3719.0,115,38,79589.0,4,2,2,8
3720.0,12,213,273980.0,2,1,1,4
3721.0,14,58,302485.0,2,1,2,5
3722.0,9,32,30596.0,1,4,2,7
3723.0,7,191,4443946.0,1,1,1,3
3724.0,2,94,134008.0,1,2,1,4
3725.0,19,115,257443.0,2,1,1,4
3726.0,196,2,3423.0,4,4,4,12
3727.0,46,13,81568.0,3,2,4,9
3728.0,9,64,151807.0,1,1,2,4
3729.0,22,42,92698.0,2,2,2,6
3730.0,4,66,161808.0,1,1,2,4
3731.0,44,6,141440.0,3,2,4,9
3732.0,81,14,55861.0,3,2,4,9
3733.0,9,268,893691.0,1,1,1,3
3734.0,50,30,61055.0,3,2,2,7
3735.0,10,205,500233.0,1,1,1,3
3736.0,51,30,72000.0,3,2,2,7
3737.0,11,135,302325.0,2,1,1,4
3738.0,15,28,82829.0,2,2,2,6
3739.0,10,43,98938.0,1,2,2,5
3740.0,6,271,665840.0,1,1,1,3
3741.0,81,2,13378.0,3,4,4,11
3742.0,5,342,2162739.0,1,1,1,3
3743.0,12,42,78809.0,2,2,2,6
3744.0,9,14,32542.0,1,4,4,9
3745.0,109,41,50842.0,4,4,2,10
3746.0,20,48,49338.0,2,4,2,8
3747.0,89,54,40925.0,4,4,2,10
3748.0,3,138,324271.0,1,1,1,3
3749.0,3,9,26970.0,1,4,4,9
3750.0,107,19,43257.0,4,4,4,12
3751.0,16,8,20344.0,2,4,4,10
3752.0,9,140,286388.0,1,1,1,3
3754.0,13,134,348584.0,2,1,1,4
3755.0,18,9,21642.0,2,4,4,10
3756.0,81,36,77671.0,3,2,2,7
3758.0,3,278,305324.0,1,1,1,3
3759.0,9,263,7545149.0,1,1,1,3
3760.0,2,107,224308.0,1,1,1,3
3761.0,10,19,62926.0,1,2,4,7
3762.0,136,61,63296.0,4,2,2,8
3763.0,204,8,15650.0,4,4,4,12
3764.0,366,17,34814.0,4,4,4,12
3765.0,12,19,216890.0,2,1,4,7
3766.0,20,54,40327.0,2,4,2,8
3767.0,10,111,91128.0,1,2,1,4
3768.0,41,37,54634.0,3,2,2,7
3769.0,9,111,116949.0,1,2,1,4
3770.0,10,28,76640.0,1,2,2,5
3771.0,20,219,246053.0,2,1,1,4
3772.0,13,9,46897.0,2,4,4,10
3773.0,20,41,95431.0,2,2,2,6
3774.0,20,5,15756.0,2,4,4,10
3775.0,13,90,222551.0,2,1,1,4
3776.0,12,78,202938.0,2,1,1,4
3777.0,44,181,95263.0,3,2,1,6
3778.0,81,14,30130.0,3,4,4,11
3779.0,81,31,70260.0,3,2,2,7
3780.0,4,82,177637.0,1,1,1,3
3781.0,10,21,50163.0,1,4,4,9
3782.0,264,24,49484.0,4,4,4,12
3783.0,59,29,56580.0,3,2,2,7
3784.0,1,85,248262.0,1,1,1,3
3785.0,2,108,446719.0,1,1,1,3
3786.0,16,12,46069.0,2,4,4,10
3787.0,39,27,62453.0,3,2,2,7
3788.0,359,10,31214.0,4,4,4,12
3789.0,81,17,42378.0,3,4,4,11
3790.0,231,40,92281.0,4,2,2,8
3791.0,26,5,114734.0,3,2,4,9
3792.0,45,18,36953.0,3,4,4,11
3793.0,9,28,88424.0,1,2,2,5
3794.0,3,38,79670.0,1,2,2,5
3795.0,15,140,353237.0,2,1,1,4
3796.0,43,52,145928.0,3,1,2,6
3797.0,81,16,37124.0,3,4,4,11
3798.0,18,88,76044.0,2,2,1,5
3799.0,17,21,51612.0,2,2,4,8
3800.0,10,369,790109.0,1,1,1,3
3801.0,25,20,42820.0,3,4,4,11
3802.0,3,1055,12267045.0,1,1,1,3
3803.0,12,105,438100.0,2,1,1,4
3804.0,163,5,43960.0,4,4,4,12
3805.0,12,40,26851.0,2,4,2,8
3806.0,9,87,76076.0,1,2,1,4
3807.0,15,137,99181.0,2,2,1,5
3808.0,48,11,21042.0,3,4,4,11
3809.0,20,83,248779.0,2,1,1,4
3810.0,54,30,74205.0,3,2,2,7
3811.0,9,46,97789.0,1,2,2,5
3812.0,2,72,155533.0,1,1,2,4
3813.0,20,33,110200.0,2,2,2,6
3814.0,362,6,18656.0,4,4,4,12
3815.0,360,9,46602.0,4,4,4,12
3816.0,5,21,129799.0,1,2,4,7
3817.0,15,48,109144.0,2,2,2,6
3818.0,2,260,465715.0,1,1,1,3
3819.0,2,390,313963.0,1,1,1,3
3820.0,14,14,37230.0,2,4,4,10
3821.0,54,9,27219.0,3,4,4,11
3822.0,47,13,24302.0,3,4,4,11
3823.0,180,3,8084.0,4,4,4,12
3824.0,9,75,126330.0,1,2,2,5
3825.0,27,9,18342.0,3,4,4,11
3826.0,25,26,68666.0,3,2,4,9
3827.0,270,25,23474.0,4,4,4,12
3828.0,50,143,82079.0,3,2,1,6
3829.0,495,2,-1199.0,4,4,4,12
3830.0,45,17,-21926.0,3,4,4,11
3831.0,26,6,25926.0,3,4,4,11
3832.0,16,42,30599.0,2,4,2,8
3833.0,360,43,38054.0,4,4,2,10
3834.0,65,50,127033.0,3,2,2,7
3835.0,12,1,25632.0,2,4,4,10
3836.0,2,87,294011.0,1,1,1,3
3837.0,19,106,66667.0,2,2,1,5
3838.0,206,6,22664.0,4,4,4,12
3839.0,20,32,57166.0,2,2,2,6
3840.0,13,27,115861.0,2,2,2,6
3841.0,20,46,24248.0,2,4,2,8
3842.0,12,64,153889.0,2,1,2,5
3843.0,25,47,50850.0,3,2,2,7
3844.0,26,152,114667.0,3,2,1,6
3845.0,8,176,541255.0,1,1,1,3
3846.0,19,29,42548.0,2,4,2,8
3847.0,17,298,194425.0,2,1,1,4
3848.0,81,12,27628.0,3,4,4,11
3849.0,9,26,50087.0,1,4,4,9
3850.0,244,8,22712.0,4,4,4,12
3851.0,14,416,441215.0,2,1,1,4
3852.0,45,6,14358.0,3,4,4,11
3853.0,6,52,55165.0,1,2,2,5
3854.0,79,44,25201.0,3,4,2,9
3855.0,1,451,1389312.0,1,1,1,3
3856.0,237,29,24992.0,4,4,2,10
3857.0,8,36,147542.0,1,1,2,4
3858.0,19,214,195492.0,2,1,1,4
3859.0,102,23,156106.0,4,1,4,9
3860.0,10,252,322560.0,1,1,1,3
3861.0,3,199,184522.0,1,1,1,3
3862.0,12,167,276390.0,2,1,1,4
3863.0,4,213,533357.0,1,1,1,3
3864.0,86,49,119006.0,4,2,2,8
3865.0,9,83,51622.0,1,2,1,4
3866.0,10,270,486410.0,1,1,1,3
3867.0,15,55,250461.0,2,1,2,5
3868.0,20,12,18438.0,2,4,4,10
3869.0,240,9,18499.0,4,4,4,12
3870.0,3,563,707881.0,1,1,1,3
3871.0,53,12,43922.0,3,4,4,11
3872.0,15,63,40635.0,2,4,2,8
3873.0,9,59,30092.0,1,4,2,7
3874.0,18,235,145359.0,2,1,1,4
3875.0,8,581,517790.0,1,1,1,3
3876.0,11,139,284393.0,2,1,1,4
3877.0,18,319,565232.0,2,1,1,4
3878.0,58,99,50070.0,3,4,1,8
3879.0,76,14,40075.0,3,4,4,11
3880.0,183,3,68672.0,4,2,4,10
3881.0,6,78,111199.0,1,2,1,4
3882.0,79,77,28476.0,3,4,1,8
3883.0,10,4,9600.0,1,4,4,9
3884.0,22,27,159048.0,2,1,2,5
3885.0,9,33,68301.0,1,2,2,5
3886.0,15,50,117884.0,2,2,2,6
3887.0,20,312,264848.0,2,1,1,4
3888.0,83,5,10681.0,3,4,4,11
3889.0,6,124,254556.0,1,1,1,3
3890.0,174,26,59408.0,4,2,4,10
3891.0,2,39,68693.0,1,2,2,5
3892.0,9,72,161258.0,1,1,2,4
3893.0,9,297,279899.0,1,1,1,3
3894.0,20,24,37062.0,2,4,4,10
3895.0,32,35,70043.0,3,2,2,7
3896.0,78,7,15066.0,3,4,4,11
3897.0,87,5,73764.0,4,2,4,10
3898.0,120,40,96992.0,4,2,2,8
3899.0,403,8,14194.0,4,4,4,12
3900.0,2,169,372880.0,1,1,1,3
3901.0,15,54,116762.0,2,2,2,6
3902.0,10,7,14801.0,1,4,4,9
3903.0,10,92,206602.0,1,1,1,3
3904.0,142,53,107078.0,4,2,2,8
3905.0,23,8,22350.0,2,4,4,10
3906.0,9,238,533690.0,1,1,1,3
3907.0,9,269,597237.0,1,1,1,3
3908.0,9,50,163383.0,1,1,2,4
3909.0,17,22,13290.0,2,4,4,10
3910.0,18,92,291151.0,2,1,1,4
3911.0,12,82,239199.0,2,1,1,4
3912.0,20,23,89052.0,2,2,4,8
3913.0,10,161,368287.0,1,1,1,3
3914.0,142,45,25600.0,4,4,2,10
3915.0,26,89,220999.0,3,1,1,5
3916.0,15,43,90555.0,2,2,2,6
3917.0,5,18,103668.0,1,2,4,7
3918.0,10,117,255356.0,1,1,1,3
3919.0,2,15,40044.0,1,4,4,9
3920.0,12,68,434140.0,2,1,2,5
3921.0,198,11,26042.0,4,4,4,12
3922.0,20,61,158482.0,2,1,2,5
3923.0,18,114,390752.0,2,1,1,4
3924.0,2,228,240673.0,1,1,1,3
3925.0,81,27,93470.0,3,2,2,7
3926.0,2,719,2425857.0,1,1,1,3
3927.0,5,78,188788.0,1,1,1,3
3928.0,2,320,2146220.0,1,1,1,3
3929.0,264,16,37982.0,4,4,4,12
3930.0,55,30,226647.0,3,1,2,6
3931.0,25,11,24248.0,3,4,4,11
3932.0,16,119,322243.0,2,1,1,4
3933.0,50,15,32961.0,3,4,4,11
3934.0,20,130,406613.0,2,1,1,4
3935.0,8,285,700078.0,1,1,1,3
3936.0,9,257,556022.0,1,1,1,3
3937.0,360,19,35218.0,4,4,4,12
3938.0,12,46,101088.0,2,2,2,6
3939.0,143,18,33760.0,4,4,4,12
3940.0,142,15,37494.0,4,4,4,12
3941.0,103,35,116128.0,4,2,2,8
3942.0,13,126,312715.0,2,1,1,4
3943.0,237,19,39956.0,4,4,4,12
3944.0,265,8,17985.0,4,4,4,12
3945.0,11,146,305113.0,2,1,1,4
3946.0,46,24,47314.0,3,4,4,11
3947.0,9,80,245808.0,1,1,1,3
3948.0,9,55,106784.0,1,2,2,5
3949.0,174,31,110221.0,4,2,2,8
3950.0,5,107,222717.0,1,1,1,3
3951.0,5,391,1213125.0,1,1,1,3
3952.0,75,5,22980.0,3,4,4,11
3953.0,14,35,31905.0,2,4,2,8
3954.0,173,7,14389.0,4,4,4,12
3955.0,20,23,52949.0,2,2,4,8
3956.0,50,29,65645.0,3,2,2,7
3957.0,321,10,19482.0,4,4,4,12
3958.0,205,1,39552.0,4,4,4,12
3959.0,9,254,706483.0,1,1,1,3
3960.0,234,6,16279.0,4,4,4,12
3961.0,9,278,665927.0,1,1,1,3
3962.0,27,50,153292.0,3,1,2,6
3963.0,11,120,305960.0,2,1,1,4
3964.0,45,10,363126.0,3,1,4,8
3965.0,59,45,114791.0,3,2,2,7
3966.0,16,198,443115.0,2,1,1,4
3967.0,20,67,141420.0,2,2,2,6
3968.0,5,167,355833.0,1,1,1,3
3969.0,4,219,706895.0,1,1,1,3
3970.0,12,83,105655.0,2,2,1,5
3971.0,373,18,34924.0,4,4,4,12
3972.0,39,35,92279.0,3,2,2,7
3973.0,54,43,94571.0,3,2,2,7
3974.0,3,690,1741880.0,1,1,1,3
3975.0,37,26,45730.0,3,4,4,11
3976.0,59,10,20859.0,3,4,4,11
3977.0,17,99,241336.0,2,1,1,4
3978.0,20,46,314957.0,2,1,2,5
3979.0,19,15,40499.0,2,4,4,10
3980.0,4,136,415866.0,1,1,1,3
3981.0,235,8,11351.0,4,4,4,12
3982.0,121,2,6396.0,4,4,4,12
3983.0,169,35,83694.0,4,2,2,8
3984.0,6,190,376828.0,1,1,1,3
3985.0,363,1,18048.0,4,4,4,12
3986.0,1,92,261516.0,1,1,1,3
3987.0,2,741,724309.0,1,1,1,3
3988.0,13,409,443948.0,2,1,1,4
3989.0,20,94,126491.0,2,2,1,5
3990.0,22,25,40530.0,2,4,4,10
3991.0,9,19,87961.0,1,2,4,7
3992.0,266,1,1800.0,4,4,4,12
3993.0,51,75,101270.0,3,2,2,7
3994.0,13,57,43617.0,2,4,2,8
3995.0,20,21,34882.0,2,4,4,10
3996.0,9,104,274665.0,1,1,1,3
3997.0,9,311,483046.0,1,1,1,3
3998.0,17,38,127685.0,2,2,2,6
3999.0,57,53,42435.0,3,4,2,9
4000.0,20,53,21215.0,2,4,2,8
4001.0,11,157,151230.0,2,1,1,4
4002.0,138,3,8400.0,4,4,4,12
4003.0,25,194,93980.0,3,2,1,6
4004.0,22,84,84891.0,2,2,1,5
4005.0,13,12,20827.0,2,4,4,10
4006.0,16,67,46934.0,2,4,2,8
4007.0,54,13,16780.0,3,4,4,11
4008.0,86,72,36660.0,4,4,2,10
4009.0,18,134,240653.0,2,1,1,4
4010.0,103,4,119191.0,4,2,4,10
4011.0,17,14,27096.0,2,4,4,10
4012.0,10,188,241317.0,1,1,1,3
4013.0,31,10,12933.0,3,4,4,11
4014.0,26,58,46409.0,3,4,2,9
4015.0,180,46,54095.0,4,2,2,8
4016.0,19,82,78482.0,2,2,1,5
4017.0,14,111,100470.0,2,2,1,5
4018.0,16,409,397218.0,2,1,1,4
4019.0,9,103,159222.0,1,1,1,3
4020.0,83,147,160585.0,3,1,1,5
4021.0,82,10,59569.0,3,2,4,9
4022.0,20,43,93687.0,2,2,2,6
4023.0,12,63,614411.0,2,1,2,5
4024.0,5,863,950527.0,1,1,1,3
4025.0,20,140,92348.0,2,2,1,5
4026.0,10,378,210536.0,1,1,1,3
4027.0,10,17,5190.0,1,4,4,9
4028.0,5,33,42564.0,1,4,2,7
4029.0,81,49,425313.0,3,1,2,6
4030.0,44,5,-2624.0,3,4,4,11
4031.0,53,13,57648.0,3,2,4,9
4032.0,6,218,259245.0,1,1,1,3
4033.0,14,78,142742.0,2,2,1,5
4034.0,299,30,109640.0,4,2,2,8
4035.0,3,23,44025.0,1,4,4,9
4036.0,9,2,4116.0,1,4,4,9
4037.0,50,61,25546.0,3,4,2,9
4038.0,3,61,53399.0,1,2,2,5
4039.0,50,23,14644.0,3,4,4,11
4040.0,10,171,180694.0,1,1,1,3
4041.0,11,136,315141.0,2,1,1,4
4042.0,50,56,45910.0,3,4,2,9
4043.0,2,7931,5123030.0,1,1,1,3
4044.0,18,35,24489.0,2,4,2,8
4045.0,111,5,8056.0,4,4,4,12
4047.0,46,51,113776.0,3,2,2,7
4048.0,19,26,69052.0,2,2,4,8
4049.0,18,312,616357.0,2,1,1,4
4050.0,20,24,14109.0,2,4,4,10
4051.0,14,15,35090.0,2,4,4,10
4052.0,373,17,28636.0,4,4,4,12
4053.0,6,17,191145.0,1,1,4,6
4054.0,9,35,1379646.0,1,1,2,4
4055.0,6,199,676906.0,1,1,1,3
4056.0,18,25,21605.0,2,4,4,10
4057.0,369,58,29949.0,4,4,2,10
4058.0,4,223,296582.0,1,1,1,3
4059.0,324,11,38352.0,4,4,4,12
4060.0,10,147,457328.0,1,1,1,3
4061.0,11,102,102530.0,2,2,1,5
4062.0,9,386,1312631.0,1,1,1,3
4063.0,143,10,43183.0,4,4,4,12
4064.0,9,80,151351.0,1,1,1,3
4065.0,16,40,48614.0,2,4,2,8
4066.0,3,280,256333.0,1,1,1,3
4067.0,205,10,24648.0,4,4,4,12
4068.0,14,45,208264.0,2,1,2,5
4069.0,14,47,76464.0,2,2,2,6
4070.0,173,12,29911.0,4,4,4,12
4071.0,50,26,58412.0,3,2,4,9
4072.0,174,6,20151.0,4,4,4,12
4073.0,367,26,63664.0,4,2,4,10
4074.0,18,8,15741.0,2,4,4,10
4075.0,4,145,87399.0,1,2,1,4
4076.0,4,117,112751.0,1,2,1,4
4077.0,20,64,27487.0,2,4,2,8
4078.0,9,109,111110.0,1,2,1,4
4079.0,42,10,12435.0,3,4,4,11
4080.0,10,80,92893.0,1,2,1,4
4081.0,214,21,25513.0,4,4,4,12
4082.0,323,94,81596.0,4,2,1,7
4083.0,74,34,38051.0,3,4,2,9
4084.0,13,28,32656.0,2,4,2,8
4085.0,137,16,23059.0,4,4,4,12
4086.0,11,192,130755.0,2,2,1,5
4087.0,50,16,16803.0,3,4,4,11
4088.0,25,2,41760.0,3,4,4,11
4089.0,173,115,65730.0,4,2,1,7
4090.0,86,28,24612.0,4,4,2,10
4091.0,13,32,24860.0,2,4,2,8
4092.0,14,11,2101.0,2,4,4,10
4093.0,9,19,12220.0,1,4,4,9
4094.0,22,37,20383.0,2,4,2,8
4095.0,13,34,97413.0,2,2,2,6
4096.0,16,12,8578.0,2,4,4,10
4097.0,403,58,33007.0,4,4,2,10
4098.0,69,39,50843.0,3,2,2,7
4099.0,79,40,38376.0,3,4,2,9
4100.0,59,59,59663.0,3,2,2,7
4101.0,4,79,51723.0,1,2,1,4
4102.0,50,94,43080.0,3,4,1,8
4103.0,89,23,174132.0,4,1,4,9
4104.0,5,695,532472.0,1,1,1,3
4105.0,10,145,101555.0,1,2,1,4
4106.0,17,1,21600.0,2,4,4,10
4107.0,3,38,346015.0,1,1,2,4
4108.0,434,1,28584.0,4,4,4,12
4109.0,134,21,57814.0,4,2,4,10
4110.0,46,22,22086.0,3,4,4,11
4111.0,119,6,87088.0,4,2,4,10
4112.0,9,39,242971.0,1,1,2,4
4113.0,138,65,56352.0,4,2,2,8
4114.0,9,90,166990.0,1,1,1,3
4115.0,57,21,98247.0,3,2,4,9
4116.0,142,28,17364.0,4,4,2,10
4117.0,6,77,50415.0,1,4,1,6
4118.0,9,43,519784.0,1,1,2,4
4119.0,43,12,12599.0,3,4,4,11
4120.0,18,17,529598.0,2,1,4,7
4121.0,103,2,38976.0,4,4,4,12
4122.0,252,2,10948.0,4,4,4,12
4123.0,234,19,17753.0,4,4,4,12
4124.0,70,9,27772.0,3,4,4,11
4125.0,148,1,43632.0,4,4,4,12
4126.0,15,35,1450852.0,2,1,2,5
4127.0,81,72,65630.0,3,2,2,7
4128.0,70,21,123680.0,3,2,4,9
4129.0,6,489,329643.0,1,1,1,3
4130.0,15,19,76010.0,2,2,4,8
4131.0,250,1,1339.0,4,4,4,12
4132.0,10,30,27737.0,1,4,2,7
4133.0,117,7,54596.0,4,2,4,10
4134.0,173,26,9646.0,4,4,4,12
4135.0,14,249,159439.0,2,1,1,4
4136.0,143,35,16813.0,4,4,2,10
4137.0,9,104,59530.0,1,2,1,4
4138.0,9,329,337614.0,1,1,1,3
4139.0,13,68,223798.0,2,1,2,5
4140.0,372,48,15607.0,4,4,2,10
4141.0,403,85,35406.0,4,4,1,9
4142.0,173,14,26572.0,4,4,4,12
4143.0,212,31,91655.0,4,2,2,8
4144.0,242,31,15456.0,4,4,2,10
4145.0,52,14,38010.0,3,4,4,11
4146.0,15,178,96012.0,2,2,1,5
4147.0,10,295,527431.0,1,1,1,3
4148.0,373,65,40567.0,4,4,2,10
4149.0,9,21,48845.0,1,4,4,9
4150.0,366,12,43618.0,4,4,4,12
4151.0,9,146,91963.0,1,2,1,4
4152.0,166,30,126434.0,4,2,2,8
4153.0,146,48,19817.0,4,4,2,10
4154.0,23,23,72051.0,2,2,4,8
4155.0,66,1,2580.0,3,4,4,11
4156.0,14,13,32105.0,2,4,4,10
4157.0,20,39,21465.0,2,4,2,8
4158.0,237,29,82070.0,4,2,2,8
4159.0,168,5,10042.0,4,4,4,12
4160.0,14,84,86595.0,2,2,1,5
4161.0,47,2,20327.0,3,4,4,11
4162.0,11,177,275497.0,2,1,1,4
4163.0,9,92,49929.0,1,4,1,6
4164.0,20,58,65468.0,2,2,2,6
4165.0,363,40,20425.0,4,4,2,10
4166.0,4,60,29991.0,1,4,2,7
4167.0,24,21,46551.0,2,4,4,10
4168.0,71,30,276938.0,3,1,2,6
4169.0,236,32,31215.0,4,4,2,10
4170.0,169,14,21562.0,4,4,4,12
4171.0,403,28,13417.0,4,4,2,10
4172.0,13,31,31322.0,2,4,2,8
4173.0,29,31,19864.0,3,4,2,9
4174.0,5,46,19647.0,1,4,2,7
4175.0,9,122,190180.0,1,1,1,3
4176.0,88,3,71200.0,4,2,4,10
4177.0,111,29,14122.0,4,4,2,10
4178.0,52,5,4221.0,3,4,4,11
4179.0,9,191,106879.0,1,2,1,4
4180.0,13,21,48809.0,2,4,4,10
4181.0,11,21,14054.0,2,4,4,10
4182.0,6,10,25714.0,1,4,4,9
4183.0,337,5,9834.0,4,4,4,12
4184.0,10,33,13844.0,1,4,2,7
4185.0,22,112,67346.0,2,2,1,5
4186.0,9,53,102388.0,1,2,2,5
4187.0,16,95,51581.0,2,2,1,5
4188.0,77,19,8013.0,3,4,4,11
4189.0,21,19,45323.0,2,4,4,10
4190.0,15,474,604176.0,2,1,1,4
4191.0,54,7,17526.0,3,4,4,11
4192.0,25,121,70219.0,3,2,1,6
4193.0,5,127,252913.0,1,1,1,3
4194.0,50,47,27159.0,3,4,2,9
4195.0,205,7,22128.0,4,4,4,12
4196.0,360,5,9554.0,4,4,4,12
4197.0,10,21,41770.0,1,4,4,9
4198.0,8,360,799373.0,1,1,1,3
4199.0,200,19,48944.0,4,4,4,12
4200.0,130,3,19696.0,4,4,4,12
4201.0,25,21,44052.0,3,4,4,11
4202.0,13,46,262679.0,2,1,2,5
4203.0,15,27,92791.0,2,2,2,6
4204.0,134,7,100126.0,4,2,4,10
4205.0,6,138,292298.0,1,1,1,3
4206.0,82,10,37070.0,3,4,4,11
4207.0,50,37,48945.0,3,4,2,9
4208.0,320,1,10716.0,4,4,4,12
4209.0,27,472,274006.0,3,1,1,5
4210.0,199,25,54812.0,4,2,4,10
4211.0,13,34,3432.0,2,4,2,8
4212.0,42,76,551439.0,3,1,2,6
4213.0,403,13,59355.0,4,2,4,10
4214.0,10,153,326306.0,1,1,1,3
4215.0,9,227,359266.0,1,1,1,3
4216.0,15,29,39746.0,2,4,2,8
4217.0,12,127,762292.0,2,1,1,4
4218.0,23,1,59592.0,2,2,4,8
4219.0,39,17,44410.0,3,4,4,11
4220.0,26,73,98389.0,3,2,2,7
4221.0,18,2,17772.0,2,4,4,10
4222.0,331,29,77731.0,4,2,2,8
4223.0,17,7,15220.0,2,4,4,10
4224.0,152,3,-14052.0,4,4,4,12
4225.0,10,39,23326.0,1,4,2,7
4226.0,4,90,1092102.0,1,1,1,3
4227.0,18,38,271296.0,2,1,2,5
4228.0,15,70,397510.0,2,1,2,5
4229.0,19,21,76805.0,2,2,4,8
4230.0,10,212,123861.0,1,2,1,4
4231.0,8,109,347407.0,1,1,1,3
4232.0,12,19,22579.0,2,4,4,10
4233.0,20,41,26205.0,2,4,2,8
4234.0,3,322,10654918.0,1,1,1,3
4235.0,9,36,90190.0,1,2,2,5
4236.0,9,18,13474.0,1,4,4,9
4237.0,330,39,49084.0,4,4,2,10
4238.0,107,19,29891.0,4,4,4,12
4239.0,2,454,1009004.0,1,1,1,3
4240.0,20,48,22670.0,2,4,2,8
4241.0,20,26,46376.0,2,4,4,10
4242.0,434,1,10080.0,4,4,4,12
4243.0,261,28,24197.0,4,4,2,10
4244.0,10,377,178366.0,1,1,1,3
4245.0,26,73,61774.0,3,2,2,7
4246.0,9,1280,707048.0,1,1,1,3
4247.0,368,30,22364.0,4,4,2,10
4248.0,15,17,13030.0,2,4,4,10
4249.0,13,32,92731.0,2,2,2,6
4250.0,9,361,244646.0,1,1,1,3
4251.0,9,36,88386.0,1,2,2,5
4252.0,9,197,147560.0,1,1,1,3
4253.0,10,55,27709.0,1,4,2,7
4254.0,20,47,43601.0,2,4,2,8
4255.0,46,14,13871.0,3,4,4,11
4256.0,9,69,140789.0,1,2,2,5
4258.0,9,20,79473.0,1,2,4,7
4259.0,67,38,88508.0,3,2,2,7
4260.0,297,8,17888.0,4,4,4,12
4261.0,20,156,1109062.0,2,1,1,4
4262.0,369,1,-4476.0,4,4,4,12
4263.0,13,18,162856.0,2,1,4,7
4264.0,117,61,126415.0,4,2,2,8
4265.0,8,43,372376.0,1,1,2,4
4266.0,20,221,418853.0,2,1,1,4
4267.0,15,10,25569.0,2,4,4,10
4268.0,53,7,27904.0,3,4,4,11
4269.0,15,16,76835.0,2,2,4,8
4270.0,9,37,73054.0,1,2,2,5
4271.0,142,38,80538.0,4,2,2,8
4272.0,4,21,55462.0,1,2,4,7
4273.0,82,28,48381.0,3,4,2,9
4274.0,20,139,87780.0,2,2,1,5
4275.0,69,35,65272.0,3,2,2,7
4276.0,18,23,59479.0,2,2,4,8
4277.0,58,39,78931.0,3,2,2,7
4278.0,10,81,205612.0,1,1,1,3
4279.0,9,23,46953.0,1,4,4,9
4280.0,179,10,41252.0,4,4,4,12
4281.0,9,43,152761.0,1,1,2,4
4282.0,18,140,146333.0,2,1,1,4
4283.0,10,9,24160.0,1,4,4,9
4284.0,9,38,116519.0,1,2,2,5
4285.0,19,56,144081.0,2,2,2,6
4286.0,9,197,892248.0,1,1,1,3
4287.0,17,31,276968.0,2,1,2,5
4288.0,99,1,14750.0,4,4,4,12
4289.0,356,33,55805.0,4,2,2,8
4290.0,9,75,165550.0,1,1,2,4
4291.0,12,99,210656.0,2,1,1,4
4292.0,19,90,252565.0,2,1,1,4
4293.0,5,117,261429.0,1,1,1,3
4294.0,25,43,44268.0,3,4,2,9
4295.0,47,44,84323.0,3,2,2,7
4296.0,25,1,6360.0,3,4,4,11
4297.0,16,17,37002.0,2,4,4,10
4298.0,20,72,267625.0,2,1,2,5
4299.0,81,69,133366.0,3,2,2,7
4300.0,105,16,35658.0,4,4,4,12
4301.0,264,7,29204.0,4,4,4,12
4302.0,81,44,109885.0,3,2,2,7
4303.0,151,18,26453.0,4,4,4,12
4304.0,84,8,123776.0,3,2,4,9
4305.0,11,141,90208.0,2,2,1,5
4306.0,5,164,757913.0,1,1,1,3
4307.0,111,32,23267.0,4,4,2,10
4308.0,48,68,168488.0,3,1,2,6
4309.0,13,19,18270.0,2,4,4,10
4310.0,75,202,258240.0,3,1,1,5
4311.0,9,32,58936.0,1,2,2,5
4312.0,9,8,16132.0,1,4,4,9
4313.0,2,134,333049.0,1,1,1,3
4314.0,17,42,77159.0,2,2,2,6
4315.0,327,42,28213.0,4,4,2,10
4316.0,237,15,34683.0,4,4,4,12
4317.0,11,13,35362.0,2,4,4,10
4318.0,9,26,57308.0,1,2,4,7
4319.0,9,31,87133.0,1,2,2,5
4320.0,17,22,87556.0,2,2,4,8
4321.0,6,115,253948.0,1,1,1,3
4322.0,220,4,56664.0,4,2,4,10
4323.0,10,65,147361.0,1,1,2,4
4324.0,11,19,59082.0,2,2,4,8
4325.0,5,296,765729.0,1,1,1,3
4326.0,265,10,19065.0,4,4,4,12
4327.0,5,284,692938.0,1,1,1,3
4328.0,12,244,684431.0,2,1,1,4
4329.0,76,5,10369.0,3,4,4,11
4330.0,52,30,84656.0,3,2,2,7
4331.0,11,164,850894.0,2,1,1,4
4332.0,9,89,340213.0,1,1,1,3
4333.0,75,126,244230.0,3,1,1,5
4334.0,14,40,73258.0,2,2,2,6
4335.0,334,1,44172.0,4,4,4,12
4336.0,15,102,254182.0,2,1,1,4
4337.0,12,48,105443.0,2,2,2,6
4338.0,3,61,131110.0,1,2,2,5
4339.0,15,88,201305.0,2,1,1,4
4340.0,50,6,51618.0,3,2,4,9
4341.0,12,105,254672.0,2,1,1,4
4342.0,81,78,268376.0,3,1,1,5
4343.0,8,177,343731.0,1,1,1,3
4344.0,32,4,67870.0,3,2,4,9
4345.0,12,49,98337.0,2,2,2,6
4346.0,20,8,14880.0,2,4,4,10
4347.0,48,22,42450.0,3,4,4,11
4348.0,88,15,693336.0,4,1,4,9
4349.0,51,98,64097.0,3,2,1,6
4350.0,90,6,13054.0,4,4,4,12
4351.0,361,4,-8769.0,4,4,4,12
4352.0,10,122,277997.0,1,1,1,3
4353.0,25,40,251350.0,3,1,2,6
4354.0,49,140,328510.0,3,1,1,5
4355.0,50,21,39209.0,3,4,4,11
4356.0,142,13,21484.0,4,4,4,12
4357.0,13,62,199329.0,2,1,2,5
4358.0,13,46,97001.0,2,2,2,6
4359.0,226,2,96.0,4,4,4,12
4360.0,366,8,18444.0,4,4,4,12
4361.0,39,12,29440.0,3,4,4,11
4362.0,3,170,413270.0,1,1,1,3
4363.0,69,3,26980.0,3,4,4,11
4364.0,20,22,292.0,2,4,4,10
4365.0,23,16,43069.0,2,4,4,10
4366.0,59,9,12837.0,3,4,4,11
4367.0,82,8,18238.0,3,4,4,11
4368.0,17,10,20480.0,2,4,4,10
4369.0,181,7,10774.0,4,4,4,12
4370.0,12,13,24962.0,2,4,4,10
4371.0,4,754,280608.0,1,1,1,3
4372.0,51,70,262820.0,3,1,2,6
